"filename", "language", "C#", "Markdown", "comment", "blank", "total"
"d:\FileFolder\Life\Unity\Projects\PVZR\PVZ_Rouge\Assets\Scripts\Classes\ConfigLists\PlantConfigList.cs", "C#", 1, 0, 0, 0, 1
"d:\FileFolder\Life\Unity\Projects\PVZR\PVZ_Rouge\Assets\Scripts\Classes\DataClasses\GlobalEntityData.cs", "C#", 7, 0, 0, 0, 7
"d:\FileFolder\Life\Unity\Projects\PVZR\PVZ_Rouge\Assets\Scripts\Classes\DataClasses\Level\LevelData.cs", "C#", -3, 0, 0, 1, -2
"d:\FileFolder\Life\Unity\Projects\PVZR\PVZ_Rouge\Assets\Scripts\Classes\DataClasses_InLevel\Attack\AttackData.cs", "C#", 10, 0, 1, 2, 13
"d:\FileFolder\Life\Unity\Projects\PVZR\PVZ_Rouge\Assets\Scripts\Classes\DataClasses_InLevel\Attack\AttackDefinition.cs", "C#", 1, 0, 0, 0, 1
"d:\FileFolder\Life\Unity\Projects\PVZR\PVZ_Rouge\Assets\Scripts\Classes\DataClasses_InLevel\Attack\AttackId.cs", "C#", 13, 0, 0, 1, 14
"d:\FileFolder\Life\Unity\Projects\PVZR\PVZ_Rouge\Assets\Scripts\Classes\DataClasses_InLevel\Cell.cs", "C#", -89, 0, -6, -20, -115
"d:\FileFolder\Life\Unity\Projects\PVZR\PVZ_Rouge\Assets\Scripts\Classes\DataClasses_InLevel\Cell\AllowedPlantingLocation.cs", "C#", 58, 0, 7, 11, 76
"d:\FileFolder\Life\Unity\Projects\PVZR\PVZ_Rouge\Assets\Scripts\Classes\DataClasses_InLevel\Cell\Cell.cs", "C#", 43, 0, 4, 9, 56
"d:\FileFolder\Life\Unity\Projects\PVZR\PVZ_Rouge\Assets\Scripts\Classes\DataClasses_InLevel\Cell\CellPlantData.cs", "C#", 109, 0, 0, 15, 124
"d:\FileFolder\Life\Unity\Projects\PVZR\PVZ_Rouge\Assets\Scripts\Classes\DataClasses_InLevel\Cell\PlacementSlot.cs", "C#", 10, 0, 3, 0, 13
"d:\FileFolder\Life\Unity\Projects\PVZR\PVZ_Rouge\Assets\Scripts\Classes\DataClasses_InLevel\Cell\TileState.cs", "C#", 13, 0, 0, 0, 13
"d:\FileFolder\Life\Unity\Projects\PVZR\PVZ_Rouge\Assets\Scripts\Classes\DataClasses_InLevel\Effect\EffectGroup.cs", "C#", 16, 0, 0, 3, 19
"d:\FileFolder\Life\Unity\Projects\PVZR\PVZ_Rouge\Assets\Scripts\Classes\DataClasses_InLevel\Effect\EffectId.cs", "C#", 1, 0, 0, 0, 1
"d:\FileFolder\Life\Unity\Projects\PVZR\PVZ_Rouge\Assets\Scripts\Classes\InfoClasses\PlantDef.cs", "C#", 4, 0, 0, 1, 5
"d:\FileFolder\Life\Unity\Projects\PVZR\PVZ_Rouge\Assets\Scripts\Classes\InfoClasses\PlantId.cs", "C#", 7, 0, 0, 0, 7
"d:\FileFolder\Life\Unity\Projects\PVZR\PVZ_Rouge\Assets\Scripts\Classes\InfoClasses\ProjectileId.cs", "C#", 7, 0, 0, 0, 7
"d:\FileFolder\Life\Unity\Projects\PVZR\PVZ_Rouge\Assets\Scripts\Classes\LootPool\LootPoolInfo.cs", "C#", 37, 0, 0, 8, 45
"d:\FileFolder\Life\Unity\Projects\PVZR\PVZ_Rouge\Assets\Scripts\Classes\MazeMap\Controllers\DaveLawnController.cs", "C#", 3, 0, 0, 2, 5
"d:\FileFolder\Life\Unity\Projects\PVZR\PVZ_Rouge\Assets\Scripts\Classes\MazeMap\MazeMapData.cs", "C#", 5, 0, 1, 4, 10
"d:\FileFolder\Life\Unity\Projects\PVZR\PVZ_Rouge\Assets\Scripts\Classes\MazeMap\MazeMapDefinition.cs", "C#", 3, 0, 1, 1, 5
"d:\FileFolder\Life\Unity\Projects\PVZR\PVZ_Rouge\Assets\Scripts\Classes\ZombieAI\PathFinding\ZombieAIUnit.cs", "C#", 4, 0, 0, 1, 5
"d:\FileFolder\Life\Unity\Projects\PVZR\PVZ_Rouge\Assets\Scripts\CommandEvents\Level_Hand\UseShovelCommand.cs", "C#", 0, 0, -1, 0, -1
"d:\FileFolder\Life\Unity\Projects\PVZR\PVZ_Rouge\Assets\Scripts\CommandEvents\Level_Zombie\OnZombieDeathCommand.cs", "C#", 1, 0, 0, 1, 2
"d:\FileFolder\Life\Unity\Projects\PVZR\PVZ_Rouge\Assets\Scripts\Docs\待办事项.md", "Markdown", 0, -3, 0, 0, -3
"d:\FileFolder\Life\Unity\Projects\PVZR\PVZ_Rouge\Assets\Scripts\Docs\抽卡理论.md", "Markdown", 0, 23, 0, 18, 41
"d:\FileFolder\Life\Unity\Projects\PVZR\PVZ_Rouge\Assets\Scripts\Docs\目前相对于原版做的创新.md", "Markdown", 0, 1, 0, 0, 1
"d:\FileFolder\Life\Unity\Projects\PVZR\PVZ_Rouge\Assets\Scripts\Helpers\ClassCreator\LootCreator.cs", "C#", 42, 0, 28, 7, 77
"d:\FileFolder\Life\Unity\Projects\PVZR\PVZ_Rouge\Assets\Scripts\Helpers\ClassCreator\TradeCreator.cs", "C#", 24, 0, 0, 7, 31
"d:\FileFolder\Life\Unity\Projects\PVZR\PVZ_Rouge\Assets\Scripts\Helpers\ConfigReader\AttackConfigReader.cs", "C#", 39, 0, 0, 10, 49
"d:\FileFolder\Life\Unity\Projects\PVZR\PVZ_Rouge\Assets\Scripts\Helpers\ConfigReader\EconomyConfigReader.cs", "C#", 129, 0, 10, 30, 169
"d:\FileFolder\Life\Unity\Projects\PVZR\PVZ_Rouge\Assets\Scripts\Helpers\ConfigReader\GameConfigReader.cs", "C#", 75, 0, 3, 16, 94
"d:\FileFolder\Life\Unity\Projects\PVZR\PVZ_Rouge\Assets\Scripts\Helpers\ConfigReader\LootPoolConfigReader.cs", "C#", 92, 0, 8, 15, 115
"d:\FileFolder\Life\Unity\Projects\PVZR\PVZ_Rouge\Assets\Scripts\Helpers\ConfigReader\PlantBookConfigReader.cs", "C#", 41, 0, 0, 10, 51
"d:\FileFolder\Life\Unity\Projects\PVZR\PVZ_Rouge\Assets\Scripts\Helpers\ConfigReader\PlantConfigReader.cs", "C#", 111, 0, 1, 22, 134
"d:\FileFolder\Life\Unity\Projects\PVZR\PVZ_Rouge\Assets\Scripts\Helpers\ConfigReader\RecipeConfigReader.cs", "C#", 88, 0, 10, 15, 113
"d:\FileFolder\Life\Unity\Projects\PVZR\PVZ_Rouge\Assets\Scripts\Helpers\ConfigReader\ZombieArmorConfigReader.cs", "C#", 40, 0, 1, 10, 51
"d:\FileFolder\Life\Unity\Projects\PVZR\PVZ_Rouge\Assets\Scripts\Helpers\DataReader\AttackConfigReader.cs", "C#", -38, 0, 0, -9, -47
"d:\FileFolder\Life\Unity\Projects\PVZR\PVZ_Rouge\Assets\Scripts\Helpers\DataReader\GameConfigReader.cs", "C#", -74, 0, -3, -15, -92
"d:\FileFolder\Life\Unity\Projects\PVZR\PVZ_Rouge\Assets\Scripts\Helpers\DataReader\PlantBookConfigReader.cs", "C#", -40, 0, 0, -9, -49
"d:\FileFolder\Life\Unity\Projects\PVZR\PVZ_Rouge\Assets\Scripts\Helpers\DataReader\PlantConfigReader.cs", "C#", -79, 0, -1, -16, -96
"d:\FileFolder\Life\Unity\Projects\PVZR\PVZ_Rouge\Assets\Scripts\Helpers\DataReader\TradeConfigReader.cs", "C#", -179, 0, -9, -36, -224
"d:\FileFolder\Life\Unity\Projects\PVZR\PVZ_Rouge\Assets\Scripts\Helpers\DataReader\ZombieArmorConfigReader.cs", "C#", -39, 0, -1, -9, -49
"d:\FileFolder\Life\Unity\Projects\PVZR\PVZ_Rouge\Assets\Scripts\Helpers\GameObjectFactory\EntityFactory.cs", "C#", 4, 0, 1, 0, 5
"d:\FileFolder\Life\Unity\Projects\PVZR\PVZ_Rouge\Assets\Scripts\Helpers\GameObjectFactory\ItemViewFactory.cs", "C#", 1, 0, 0, 2, 3
"d:\FileFolder\Life\Unity\Projects\PVZR\PVZ_Rouge\Assets\Scripts\Helpers\GameObjectFactory\ShitFactory.cs", "C#", 1, 0, 0, 2, 3
"d:\FileFolder\Life\Unity\Projects\PVZR\PVZ_Rouge\Assets\Scripts\Helpers\Methods\LevelMatrixHelper.cs", "C#", 1, 0, 0, 1, 2
"d:\FileFolder\Life\Unity\Projects\PVZR\PVZ_Rouge\Assets\Scripts\Models\LevelGridModel.cs", "C#", -16, 0, 1, 1, -14
"d:\FileFolder\Life\Unity\Projects\PVZR\PVZ_Rouge\Assets\Scripts\Systems\Level_Data\LevelSystem.cs", "C#", 0, 0, 1, 0, 1
"d:\FileFolder\Life\Unity\Projects\PVZR\PVZ_Rouge\Assets\Scripts\Systems\MainGameSystem.cs", "C#", 1, 0, 0, 1, 2
"d:\FileFolder\Life\Unity\Projects\PVZR\PVZ_Rouge\Assets\Scripts\Systems\MazeMap\CoinStoreSystem.cs", "C#", 16, 0, 0, 2, 18
"d:\FileFolder\Life\Unity\Projects\PVZR\PVZ_Rouge\Assets\Scripts\Tools\CollisionDetector.cs", "C#", 4, 0, 2, 5, 11
"d:\FileFolder\Life\Unity\Projects\PVZR\PVZ_Rouge\Assets\Scripts\Tools\Extensions.cs", "C#", 16, 0, 8, 1, 25
"d:\FileFolder\Life\Unity\Projects\PVZR\PVZ_Rouge\Assets\Scripts\ViewControllers\Entities\Plants\Base\Plant.cs", "C#", 10, 0, 0, 1, 11
"d:\FileFolder\Life\Unity\Projects\PVZR\PVZ_Rouge\Assets\Scripts\ViewControllers\Entities\Plants\Dave\BonkChoy.cs", "C#", 41, 0, 0, 7, 48
"d:\FileFolder\Life\Unity\Projects\PVZR\PVZ_Rouge\Assets\Scripts\ViewControllers\Entities\Plants\Dave\Tallnut.cs", "C#", 15, 0, 0, 2, 17
"d:\FileFolder\Life\Unity\Projects\PVZR\PVZ_Rouge\Assets\Scripts\ViewControllers\Entities\Plants\General\Flowerpot.cs", "C#", 3, 0, 0, 0, 3
"d:\FileFolder\Life\Unity\Projects\PVZR\PVZ_Rouge\Assets\Scripts\ViewControllers\Entities\Plants\General\Jalapeno.cs", "C#", 38, 0, 0, 8, 46
"d:\FileFolder\Life\Unity\Projects\PVZR\PVZ_Rouge\Assets\Scripts\ViewControllers\Entities\Plants\General\Pumpkin.cs", "C#", 23, 0, 0, 3, 26
"d:\FileFolder\Life\Unity\Projects\PVZR\PVZ_Rouge\Assets\Scripts\ViewControllers\Entities\Plants\General\Squash.cs", "C#", 64, 0, 0, 11, 75
"d:\FileFolder\Life\Unity\Projects\PVZR\PVZ_Rouge\Assets\Scripts\ViewControllers\Entities\Plants\PeaFamily\Threepeater.cs", "C#", 1, 0, 0, 0, 1
"d:\FileFolder\Life\Unity\Projects\PVZR\PVZ_Rouge\Assets\Scripts\ViewControllers\Entities\Plants\PeaFamily\Torchwood.cs", "C#", 31, 0, 0, 6, 37
"d:\FileFolder\Life\Unity\Projects\PVZR\PVZ_Rouge\Assets\Scripts\ViewControllers\Entities\Plants\PultFamily\CabbagePult.cs", "C#", 41, 0, 0, 8, 49
"d:\FileFolder\Life\Unity\Projects\PVZR\PVZ_Rouge\Assets\Scripts\ViewControllers\Entities\Projectiles\Base\ICanBeIgnited.cs", "C#", 12, 0, 0, 1, 13
"d:\FileFolder\Life\Unity\Projects\PVZR\PVZ_Rouge\Assets\Scripts\ViewControllers\Entities\Projectiles\Base\IPeaLikeInit.cs", "C#", 9, 0, 0, 1, 10
"d:\FileFolder\Life\Unity\Projects\PVZR\PVZ_Rouge\Assets\Scripts\ViewControllers\Entities\Projectiles\Base\IProjectile.cs", "C#", 7, 0, 0, 1, 8
"d:\FileFolder\Life\Unity\Projects\PVZR\PVZ_Rouge\Assets\Scripts\ViewControllers\Entities\Projectiles\Base\Projectile.cs", "C#", 14, 0, 0, 4, 18
"d:\FileFolder\Life\Unity\Projects\PVZR\PVZ_Rouge\Assets\Scripts\ViewControllers\Entities\Projectiles\Cabbage.cs", "C#", 31, 0, 0, 6, 37
"d:\FileFolder\Life\Unity\Projects\PVZR\PVZ_Rouge\Assets\Scripts\ViewControllers\Entities\Projectiles\FirePea.cs", "C#", 40, 0, 0, 6, 46
"d:\FileFolder\Life\Unity\Projects\PVZR\PVZ_Rouge\Assets\Scripts\ViewControllers\Entities\Projectiles\FrozenPea.cs", "C#", 2, 0, 0, 1, 3
"d:\FileFolder\Life\Unity\Projects\PVZR\PVZ_Rouge\Assets\Scripts\ViewControllers\Entities\Projectiles\IPeaLikeInit.cs", "C#", -9, 0, 0, -1, -10
"d:\FileFolder\Life\Unity\Projects\PVZR\PVZ_Rouge\Assets\Scripts\ViewControllers\Entities\Projectiles\IProjectile.cs", "C#", -7, 0, 0, -1, -8
"d:\FileFolder\Life\Unity\Projects\PVZR\PVZ_Rouge\Assets\Scripts\ViewControllers\Entities\Projectiles\MungBean.cs", "C#", 2, 0, 0, 1, 3
"d:\FileFolder\Life\Unity\Projects\PVZR\PVZ_Rouge\Assets\Scripts\ViewControllers\Entities\Projectiles\Pea.cs", "C#", 24, 0, 0, 3, 27
"d:\FileFolder\Life\Unity\Projects\PVZR\PVZ_Rouge\Assets\Scripts\ViewControllers\Entities\Projectiles\Projectile.cs", "C#", -14, 0, 0, -2, -16
"d:\FileFolder\Life\Unity\Projects\PVZR\PVZ_Rouge\Assets\Scripts\ViewControllers\Entities\Projectiles\SnipePea.cs", "C#", 2, 0, 0, 1, 3
"d:\FileFolder\Life\Unity\Projects\PVZR\PVZ_Rouge\Assets\Scripts\ViewControllers\Entities\Projectiles\Spike.cs", "C#", 2, 0, 0, 1, 3
"d:\FileFolder\Life\Unity\Projects\PVZR\PVZ_Rouge\Assets\Scripts\ViewControllers\Entities\Projectiles\Star.cs", "C#", 4, 0, 0, 1, 5
"d:\FileFolder\Life\Unity\Projects\PVZR\PVZ_Rouge\Assets\Scripts\ViewControllers\Entities\Zombies\Base\Zombie.cs", "C#", 10, 0, 1, 6, 17
"d:\FileFolder\Life\Unity\Projects\PVZR\PVZ_Rouge\Assets\Scripts\ViewControllers\Entities\Zombies\Instances\NewspaperZombie.cs", "C#", 1, 0, 0, 0, 1
"d:\FileFolder\Life\Unity\Projects\PVZR\PVZ_Rouge\Assets\Scripts\ViewControllers\Entities\Zombies\States\DeadState.cs", "C#", 11, 0, 0, 1, 12
"d:\FileFolder\Life\Unity\Projects\PVZR\PVZ_Rouge\Assets\Scripts\ViewControllers\Entities\Zombies\States\ZombieState.cs", "C#", 1, 0, 0, 0, 1
"d:\FileFolder\Life\Unity\Projects\PVZR\PVZ_Rouge\Assets\Scripts\ViewControllers\Managers\TestDataManager.cs", "C#", 0, 0, 0, -1, -1
"d:\FileFolder\Life\Unity\Projects\PVZR\PVZ_Rouge\Assets\Scripts\ViewControllers\Others\LevelScene\FollowingImage.cs", "C#", 6, 0, 0, 3, 9
"d:\FileFolder\Life\Unity\Projects\PVZR\PVZ_Rouge\Assets\Scripts\ViewControllers\UI\LevelScene\LevelStateBarPanelController.cs", "C#", 2, 0, 0, -1, 1
"Total", "-", 938, 21, 71, 198, 1228