"filename", "language", "C#", "Markdown", "comment", "blank", "total"
"d:\FileFolder\Life\Unity\Projects\PVZR\PVZ_Rouge\Assets\Scripts\Classes\ConfigLists\AttackDefinitionList.cs", "C#", 18, 0, 0, 2, 20
"d:\FileFolder\Life\Unity\Projects\PVZR\PVZ_Rouge\Assets\Scripts\Classes\ConfigLists\GameDefinitionList.cs", "C#", 18, 0, 0, 2, 20
"d:\FileFolder\Life\Unity\Projects\PVZR\PVZ_Rouge\Assets\Scripts\Classes\ConfigLists\ItemValueList.cs", "C#", 11, 0, 0, 1, 12
"d:\FileFolder\Life\Unity\Projects\PVZR\PVZ_Rouge\Assets\Scripts\Classes\ConfigLists\LevelDefinitionList.cs", "C#", 18, 0, 0, 2, 20
"d:\FileFolder\Life\Unity\Projects\PVZR\PVZ_Rouge\Assets\Scripts\Classes\ConfigLists\MazeMapDefinitionList.cs", "C#", 18, 0, 0, 2, 20
"d:\FileFolder\Life\Unity\Projects\PVZR\PVZ_Rouge\Assets\Scripts\Classes\ConfigLists\PlantBookDefinitionList.cs", "C#", 18, 0, 0, 2, 20
"d:\FileFolder\Life\Unity\Projects\PVZR\PVZ_Rouge\Assets\Scripts\Classes\ConfigLists\PlantConfigList.cs", "C#", 20, 0, 0, 3, 23
"d:\FileFolder\Life\Unity\Projects\PVZR\PVZ_Rouge\Assets\Scripts\Classes\ConfigLists\RecipeConfigList.cs", "C#", 10, 0, 0, 1, 11
"d:\FileFolder\Life\Unity\Projects\PVZR\PVZ_Rouge\Assets\Scripts\Classes\ConfigLists\ZombieArmorDefinitionList.cs", "C#", 18, 0, 0, 2, 20
"d:\FileFolder\Life\Unity\Projects\PVZR\PVZ_Rouge\Assets\Scripts\Classes\DataClasses\CoinTrade\CoinTradeData.cs", "C#", 20, 0, 0, 4, 24
"d:\FileFolder\Life\Unity\Projects\PVZR\PVZ_Rouge\Assets\Scripts\Classes\DataClasses\CoinTrade\CoinTradeGenerateInfo.cs", "C#", 16, 0, 0, 2, 18
"d:\FileFolder\Life\Unity\Projects\PVZR\PVZ_Rouge\Assets\Scripts\Classes\DataClasses\CoinTrade\CoinTradeInfo.cs", "C#", 11, 0, 0, 1, 12
"d:\FileFolder\Life\Unity\Projects\PVZR\PVZ_Rouge\Assets\Scripts\Classes\DataClasses\Game\GameData.cs", "C#", 49, 0, 1, 7, 57
"d:\FileFolder\Life\Unity\Projects\PVZR\PVZ_Rouge\Assets\Scripts\Classes\DataClasses\Game\GameDef.cs", "C#", 10, 0, 0, 1, 11
"d:\FileFolder\Life\Unity\Projects\PVZR\PVZ_Rouge\Assets\Scripts\Classes\DataClasses\Game\GameDefinition.cs", "C#", 14, 0, 0, 1, 15
"d:\FileFolder\Life\Unity\Projects\PVZR\PVZ_Rouge\Assets\Scripts\Classes\DataClasses\Game\GameId.cs", "C#", 8, 0, 0, 0, 8
"d:\FileFolder\Life\Unity\Projects\PVZR\PVZ_Rouge\Assets\Scripts\Classes\DataClasses\GlobalEntityData.cs", "C#", 23, 0, 0, 2, 25
"d:\FileFolder\Life\Unity\Projects\PVZR\PVZ_Rouge\Assets\Scripts\Classes\DataClasses\InventoryData.cs", "C#", 239, 0, 8, 58, 305
"d:\FileFolder\Life\Unity\Projects\PVZR\PVZ_Rouge\Assets\Scripts\Classes\DataClasses\Item\Card\CardData.cs", "C#", 29, 0, 0, 4, 33
"d:\FileFolder\Life\Unity\Projects\PVZR\PVZ_Rouge\Assets\Scripts\Classes\DataClasses\Item\Card\CardDefinition.cs", "C#", 16, 0, 2, 4, 22
"d:\FileFolder\Life\Unity\Projects\PVZR\PVZ_Rouge\Assets\Scripts\Classes\DataClasses\Item\Card\CardQuality.cs", "C#", 11, 0, 0, 0, 11
"d:\FileFolder\Life\Unity\Projects\PVZR\PVZ_Rouge\Assets\Scripts\Classes\DataClasses\Item\ItemData.cs", "C#", 8, 0, 0, 1, 9
"d:\FileFolder\Life\Unity\Projects\PVZR\PVZ_Rouge\Assets\Scripts\Classes\DataClasses\Item\ItemType.cs", "C#", 8, 0, 0, 0, 8
"d:\FileFolder\Life\Unity\Projects\PVZR\PVZ_Rouge\Assets\Scripts\Classes\DataClasses\Item\PlantBook\PlantBookData.cs", "C#", 31, 0, 1, 7, 39
"d:\FileFolder\Life\Unity\Projects\PVZR\PVZ_Rouge\Assets\Scripts\Classes\DataClasses\Item\PlantBook\PlantBookDefinition.cs", "C#", 14, 0, 0, 1, 15
"d:\FileFolder\Life\Unity\Projects\PVZR\PVZ_Rouge\Assets\Scripts\Classes\DataClasses\Item\PlantBook\PlantBookId.cs", "C#", 8, 0, 0, 0, 8
"d:\FileFolder\Life\Unity\Projects\PVZR\PVZ_Rouge\Assets\Scripts\Classes\DataClasses\Level\LevelData.cs", "C#", 201, 0, 6, 71, 278
"d:\FileFolder\Life\Unity\Projects\PVZR\PVZ_Rouge\Assets\Scripts\Classes\DataClasses\Level\LevelDef.cs", "C#", 35, 0, 0, 7, 42
"d:\FileFolder\Life\Unity\Projects\PVZR\PVZ_Rouge\Assets\Scripts\Classes\DataClasses\Level\LevelDefinition.cs", "C#", 107, 0, 0, 21, 128
"d:\FileFolder\Life\Unity\Projects\PVZR\PVZ_Rouge\Assets\Scripts\Classes\DataClasses\Level\LevelId.cs", "C#", 10, 0, 21, 1, 32
"d:\FileFolder\Life\Unity\Projects\PVZR\PVZ_Rouge\Assets\Scripts\Classes\DataClasses\Loot\LootData.cs", "C#", 40, 0, 3, 7, 50
"d:\FileFolder\Life\Unity\Projects\PVZR\PVZ_Rouge\Assets\Scripts\Classes\DataClasses\Loot\LootGenerateInfo.cs", "C#", 16, 0, 0, 2, 18
"d:\FileFolder\Life\Unity\Projects\PVZR\PVZ_Rouge\Assets\Scripts\Classes\DataClasses\Loot\LootInfo.cs", "C#", 15, 0, 3, 4, 22
"d:\FileFolder\Life\Unity\Projects\PVZR\PVZ_Rouge\Assets\Scripts\Classes\DataClasses\Loot\LootPool.cs", "C#", 71, 0, 0, 12, 83
"d:\FileFolder\Life\Unity\Projects\PVZR\PVZ_Rouge\Assets\Scripts\Classes\DataClasses\Loot\LootType.cs", "C#", 10, 0, 0, 0, 10
"d:\FileFolder\Life\Unity\Projects\PVZR\PVZ_Rouge\Assets\Scripts\Classes\DataClasses\Recipe\RecipeData.cs", "C#", 22, 0, 0, 2, 24
"d:\FileFolder\Life\Unity\Projects\PVZR\PVZ_Rouge\Assets\Scripts\Classes\DataClasses\Recipe\RecipeGenerateInfo.cs", "C#", 14, 0, 0, 1, 15
"d:\FileFolder\Life\Unity\Projects\PVZR\PVZ_Rouge\Assets\Scripts\Classes\DataClasses\Recipe\RecipeInfo.cs", "C#", 15, 0, 0, 1, 16
"d:\FileFolder\Life\Unity\Projects\PVZR\PVZ_Rouge\Assets\Scripts\Classes\DataClasses\Tomb\TombData.cs", "C#", 64, 0, 1, 10, 75
"d:\FileFolder\Life\Unity\Projects\PVZR\PVZ_Rouge\Assets\Scripts\Classes\DataClasses_InLevel\Attack\AttackData.cs", "C#", 99, 0, 0, 22, 121
"d:\FileFolder\Life\Unity\Projects\PVZR\PVZ_Rouge\Assets\Scripts\Classes\DataClasses_InLevel\Attack\AttackDefinition.cs", "C#", 21, 0, 0, 2, 23
"d:\FileFolder\Life\Unity\Projects\PVZR\PVZ_Rouge\Assets\Scripts\Classes\DataClasses_InLevel\Attack\AttackId.cs", "C#", 14, 0, 0, 0, 14
"d:\FileFolder\Life\Unity\Projects\PVZR\PVZ_Rouge\Assets\Scripts\Classes\DataClasses_InLevel\Cell.cs", "C#", 43, 0, 3, 9, 55
"d:\FileFolder\Life\Unity\Projects\PVZR\PVZ_Rouge\Assets\Scripts\Classes\DataClasses_InLevel\Effect\EffectData.cs", "C#", 29, 0, 0, 6, 35
"d:\FileFolder\Life\Unity\Projects\PVZR\PVZ_Rouge\Assets\Scripts\Classes\DataClasses_InLevel\Effect\EffectDefinition.cs", "C#", 12, 0, 0, 1, 13
"d:\FileFolder\Life\Unity\Projects\PVZR\PVZ_Rouge\Assets\Scripts\Classes\DataClasses_InLevel\Effect\EffectGroup.cs", "C#", 59, 0, 5, 7, 71
"d:\FileFolder\Life\Unity\Projects\PVZR\PVZ_Rouge\Assets\Scripts\Classes\DataClasses_InLevel\Effect\EffectId.cs", "C#", 7, 0, 0, 0, 7
"d:\FileFolder\Life\Unity\Projects\PVZR\PVZ_Rouge\Assets\Scripts\Classes\DataClasses_InLevel\SeedData.cs", "C#", 22, 0, 2, 6, 30
"d:\FileFolder\Life\Unity\Projects\PVZR\PVZ_Rouge\Assets\Scripts\Classes\DataClasses_InLevel\ZombieArmor\ArmorState.cs", "C#", 10, 0, 0, 0, 10
"d:\FileFolder\Life\Unity\Projects\PVZR\PVZ_Rouge\Assets\Scripts\Classes\DataClasses_InLevel\ZombieArmor\ZombieArmorData.cs", "C#", 68, 0, 7, 17, 92
"d:\FileFolder\Life\Unity\Projects\PVZR\PVZ_Rouge\Assets\Scripts\Classes\DataClasses_InLevel\ZombieArmor\ZombieArmorDefinition.cs", "C#", 14, 0, 0, 2, 16
"d:\FileFolder\Life\Unity\Projects\PVZR\PVZ_Rouge\Assets\Scripts\Classes\DataClasses_InLevel\ZombieArmor\ZombieArmorId.cs", "C#", 11, 0, 0, 0, 11
"d:\FileFolder\Life\Unity\Projects\PVZR\PVZ_Rouge\Assets\Scripts\Classes\InfoClasses\PlantDef.cs", "C#", 35, 0, 0, 7, 42
"d:\FileFolder\Life\Unity\Projects\PVZR\PVZ_Rouge\Assets\Scripts\Classes\InfoClasses\PlantId.cs", "C#", 20, 0, 6, 2, 28
"d:\FileFolder\Life\Unity\Projects\PVZR\PVZ_Rouge\Assets\Scripts\Classes\InfoClasses\PlantVariant.cs", "C#", 18, 0, 0, 1, 19
"d:\FileFolder\Life\Unity\Projects\PVZR\PVZ_Rouge\Assets\Scripts\Classes\InfoClasses\ProjectileId.cs", "C#", 13, 0, 0, 1, 14
"d:\FileFolder\Life\Unity\Projects\PVZR\PVZ_Rouge\Assets\Scripts\Classes\InfoClasses\ZombieId.cs", "C#", 14, 0, 0, 1, 15
"d:\FileFolder\Life\Unity\Projects\PVZR\PVZ_Rouge\Assets\Scripts\Classes\MazeMap\Controllers\DaveLawnController.cs", "C#", 295, 0, 46, 48, 389
"d:\FileFolder\Life\Unity\Projects\PVZR\PVZ_Rouge\Assets\Scripts\Classes\MazeMap\MazeMapController.cs", "C#", 183, 0, 10, 52, 245
"d:\FileFolder\Life\Unity\Projects\PVZR\PVZ_Rouge\Assets\Scripts\Classes\MazeMap\MazeMapData.cs", "C#", 123, 0, 4, 30, 157
"d:\FileFolder\Life\Unity\Projects\PVZR\PVZ_Rouge\Assets\Scripts\Classes\MazeMap\MazeMapDef.cs", "C#", 34, 0, 0, 7, 41
"d:\FileFolder\Life\Unity\Projects\PVZR\PVZ_Rouge\Assets\Scripts\Classes\MazeMap\MazeMapDefinition.cs", "C#", 47, 0, 1, 7, 55
"d:\FileFolder\Life\Unity\Projects\PVZR\PVZ_Rouge\Assets\Scripts\Classes\MazeMap\MazeMapId.cs", "C#", 9, 0, 0, 1, 10
"d:\FileFolder\Life\Unity\Projects\PVZR\PVZ_Rouge\Assets\Scripts\Classes\MazeMap\Node.cs", "C#", 48, 0, 3, 6, 57
"d:\FileFolder\Life\Unity\Projects\PVZR\PVZ_Rouge\Assets\Scripts\Classes\MazeMap\Workflow.md", "Markdown", 0, 0, 0, 1, 1
"d:\FileFolder\Life\Unity\Projects\PVZR\PVZ_Rouge\Assets\Scripts\Classes\ZombieAI\Class\Cluster.cs", "C#", 56, 0, 0, 13, 69
"d:\FileFolder\Life\Unity\Projects\PVZR\PVZ_Rouge\Assets\Scripts\Classes\ZombieAI\Class\Edge.cs", "C#", 24, 0, 0, 5, 29
"d:\FileFolder\Life\Unity\Projects\PVZR\PVZ_Rouge\Assets\Scripts\Classes\ZombieAI\Class\EdgeWeightCalculator.cs", "C#", 37, 0, 3, 8, 48
"d:\FileFolder\Life\Unity\Projects\PVZR\PVZ_Rouge\Assets\Scripts\Classes\ZombieAI\Class\FromToKey.cs", "C#", 26, 0, 0, 5, 31
"d:\FileFolder\Life\Unity\Projects\PVZR\PVZ_Rouge\Assets\Scripts\Classes\ZombieAI\Class\KeyEdge.cs", "C#", 85, 0, 9, 24, 118
"d:\FileFolder\Life\Unity\Projects\PVZR\PVZ_Rouge\Assets\Scripts\Classes\ZombieAI\Class\Path.cs", "C#", 52, 0, 27, 16, 95
"d:\FileFolder\Life\Unity\Projects\PVZR\PVZ_Rouge\Assets\Scripts\Classes\ZombieAI\Class\PathKey.cs", "C#", 27, 0, 0, 4, 31
"d:\FileFolder\Life\Unity\Projects\PVZR\PVZ_Rouge\Assets\Scripts\Classes\ZombieAI\Class\Vertex.cs", "C#", 55, 0, 7, 18, 80
"d:\FileFolder\Life\Unity\Projects\PVZR\PVZ_Rouge\Assets\Scripts\Classes\ZombieAI\PathFinding\AStarPathfinder.cs", "C#", 164, 0, 15, 38, 217
"d:\FileFolder\Life\Unity\Projects\PVZR\PVZ_Rouge\Assets\Scripts\Classes\ZombieAI\PathFinding\PathCache.cs", "C#", 46, 0, 0, 12, 58
"d:\FileFolder\Life\Unity\Projects\PVZR\PVZ_Rouge\Assets\Scripts\Classes\ZombieAI\PathFinding\PathFindingAlgorithm.cs", "C#", 46, 0, 5, 5, 56
"d:\FileFolder\Life\Unity\Projects\PVZR\PVZ_Rouge\Assets\Scripts\Classes\ZombieAI\PathFinding\PathManager.cs", "C#", 107, 0, 12, 31, 150
"d:\FileFolder\Life\Unity\Projects\PVZR\PVZ_Rouge\Assets\Scripts\Classes\ZombieAI\PathFinding\ZombieAIUnit.cs", "C#", 503, 0, 141, 106, 750
"d:\FileFolder\Life\Unity\Projects\PVZR\PVZ_Rouge\Assets\Scripts\Classes\ZombieAI\Public\AITendency.cs", "C#", 76, 0, 28, 25, 129
"d:\FileFolder\Life\Unity\Projects\PVZR\PVZ_Rouge\Assets\Scripts\Classes\ZombieAI\Public\IZombieAIUnit.cs", "C#", 17, 0, 3, 1, 21
"d:\FileFolder\Life\Unity\Projects\PVZR\PVZ_Rouge\Assets\Scripts\Classes\ZombieAI\Public\IZombiePath.cs", "C#", 41, 0, 1, 9, 51
"d:\FileFolder\Life\Unity\Projects\PVZR\PVZ_Rouge\Assets\Scripts\Classes\ZombieAI\Public\MoveData.cs", "C#", 32, 0, 1, 5, 38
"d:\FileFolder\Life\Unity\Projects\PVZR\PVZ_Rouge\Assets\Scripts\Classes\ZombieAI\Public\MoveType.cs", "C#", 18, 0, 0, 1, 19
"d:\FileFolder\Life\Unity\Projects\PVZR\PVZ_Rouge\Assets\Scripts\Classes\ZombieSpawner\ZombieSpawnInfo.cs", "C#", 21, 0, 0, 2, 23
"d:\FileFolder\Life\Unity\Projects\PVZR\PVZ_Rouge\Assets\Scripts\Classes\ZombieSpawner\ZombieSpawnTask.cs", "C#", 69, 0, 5, 16, 90
"d:\FileFolder\Life\Unity\Projects\PVZR\PVZ_Rouge\Assets\Scripts\CommandEvents\Level_ChooseSeeds\ChooseSeedCommand.cs", "C#", 58, 0, 7, 8, 73
"d:\FileFolder\Life\Unity\Projects\PVZR\PVZ_Rouge\Assets\Scripts\CommandEvents\Level_ChooseSeeds\OnStartGameBtnPressedCommand.cs", "C#", 15, 0, 2, 2, 19
"d:\FileFolder\Life\Unity\Projects\PVZR\PVZ_Rouge\Assets\Scripts\CommandEvents\Level_ChooseSeeds\UnchooseSeedCommand.cs", "C#", 55, 0, 7, 8, 70
"d:\FileFolder\Life\Unity\Projects\PVZR\PVZ_Rouge\Assets\Scripts\CommandEvents\Level_Gameplay\Coins\CollectCoinCommand.cs", "C#", 33, 0, 0, 6, 39
"d:\FileFolder\Life\Unity\Projects\PVZR\PVZ_Rouge\Assets\Scripts\CommandEvents\Level_Gameplay\Coins\SpawnCoinFromPlantCommand.cs", "C#", 27, 0, 0, 4, 31
"d:\FileFolder\Life\Unity\Projects\PVZR\PVZ_Rouge\Assets\Scripts\CommandEvents\Level_Gameplay\CollectSunCommand.cs", "C#", 25, 0, 0, 5, 30
"d:\FileFolder\Life\Unity\Projects\PVZR\PVZ_Rouge\Assets\Scripts\CommandEvents\Level_Gameplay\HandInputs\DeselectCommand.cs", "C#", 23, 0, 2, 3, 28
"d:\FileFolder\Life\Unity\Projects\PVZR\PVZ_Rouge\Assets\Scripts\CommandEvents\Level_Gameplay\HandInputs\HandEvents.cs", "C#", 24, 0, 0, 5, 29
"d:\FileFolder\Life\Unity\Projects\PVZR\PVZ_Rouge\Assets\Scripts\CommandEvents\Level_Gameplay\HandInputs\PlantingSeedInHandCommand.cs", "C#", 41, 0, 1, 5, 47
"d:\FileFolder\Life\Unity\Projects\PVZR\PVZ_Rouge\Assets\Scripts\CommandEvents\Level_Gameplay\HandInputs\SelectSeedCommand.cs", "C#", 33, 0, 2, 4, 39
"d:\FileFolder\Life\Unity\Projects\PVZR\PVZ_Rouge\Assets\Scripts\CommandEvents\Level_Gameplay\HandInputs\SelectShovelCommand.cs", "C#", 23, 0, 2, 3, 28
"d:\FileFolder\Life\Unity\Projects\PVZR\PVZ_Rouge\Assets\Scripts\CommandEvents\Level_Gameplay\HandInputs\UseShovelCommand.cs", "C#", 39, 0, 2, 5, 46
"d:\FileFolder\Life\Unity\Projects\PVZR\PVZ_Rouge\Assets\Scripts\CommandEvents\Level_Gameplay\PlantSpawn\KillPlantCommand.cs", "C#", 0, 0, 32, 0, 32
"d:\FileFolder\Life\Unity\Projects\PVZR\PVZ_Rouge\Assets\Scripts\CommandEvents\Level_Gameplay\PlantSpawn\PlantSpawnEvents.cs", "C#", 9, 0, 0, 2, 11
"d:\FileFolder\Life\Unity\Projects\PVZR\PVZ_Rouge\Assets\Scripts\CommandEvents\Level_Gameplay\PlantSpawn\SpawnPlantCommand.cs", "C#", 39, 0, 2, 5, 46
"d:\FileFolder\Life\Unity\Projects\PVZR\PVZ_Rouge\Assets\Scripts\CommandEvents\Level_Gameplay\SpawnSunFromPlantCommand.cs", "C#", 30, 0, 0, 4, 34
"d:\FileFolder\Life\Unity\Projects\PVZR\PVZ_Rouge\Assets\Scripts\CommandEvents\Level_Gameplay\Waves\WaveEvents.cs", "C#", 7, 0, 0, 0, 7
"d:\FileFolder\Life\Unity\Projects\PVZR\PVZ_Rouge\Assets\Scripts\CommandEvents\MazeMap_AwardPanel\ChooseAwardCommand.cs", "C#", 25, 0, 0, 6, 31
"d:\FileFolder\Life\Unity\Projects\PVZR\PVZ_Rouge\Assets\Scripts\CommandEvents\MazeMap_StorePanel\BarterCommand.cs", "C#", 29, 0, 2, 8, 39
"d:\FileFolder\Life\Unity\Projects\PVZR\PVZ_Rouge\Assets\Scripts\CommandEvents\MazeMap_StorePanel\CoinStoreRefreshCommand.cs", "C#", 22, 0, 2, 4, 28
"d:\FileFolder\Life\Unity\Projects\PVZR\PVZ_Rouge\Assets\Scripts\CommandEvents\MazeMap_StorePanel\CoinTradeCommand.cs", "C#", 31, 0, 2, 8, 41
"d:\FileFolder\Life\Unity\Projects\PVZR\PVZ_Rouge\Assets\Scripts\CommandEvents\MazeMap_StorePanel\SellTradeCommand.cs", "C#", 31, 0, 2, 6, 39
"d:\FileFolder\Life\Unity\Projects\PVZR\PVZ_Rouge\Assets\Scripts\CommandEvents\Phase\PhaseEvents.cs", "C#", 20, 0, 0, 2, 22
"d:\FileFolder\Life\Unity\Projects\PVZR\PVZ_Rouge\Assets\Scripts\CommandEvents\_NotClassified_\EndCurrentGameCommand.cs", "C#", 18, 0, 2, 2, 22
"d:\FileFolder\Life\Unity\Projects\PVZR\PVZ_Rouge\Assets\Scripts\CommandEvents\_NotClassified_\OnCollectLevelEndObjectCommand.cs", "C#", 15, 0, 2, 3, 20
"d:\FileFolder\Life\Unity\Projects\PVZR\PVZ_Rouge\Assets\Scripts\CommandEvents\_NotClassified_\OnZombieDeathCommand.cs", "C#", 38, 0, 4, 6, 48
"d:\FileFolder\Life\Unity\Projects\PVZR\PVZ_Rouge\Assets\Scripts\CommandEvents\_NotClassified_\PressTempStartGameButtonCommand.cs", "C#", 0, 0, 0, 1, 1
"d:\FileFolder\Life\Unity\Projects\PVZR\PVZ_Rouge\Assets\Scripts\CommandEvents\_NotClassified_\SomeEvents.cs", "C#", 9, 0, 0, 3, 12
"d:\FileFolder\Life\Unity\Projects\PVZR\PVZ_Rouge\Assets\Scripts\CommandEvents\_NotClassified_\StartGameCommand.cs", "C#", 26, 0, 1, 5, 32
"d:\FileFolder\Life\Unity\Projects\PVZR\PVZ_Rouge\Assets\Scripts\CommandEvents\_NotClassified_\StartLevelCommands.cs", "C#", 25, 0, 2, 6, 33
"d:\FileFolder\Life\Unity\Projects\PVZR\PVZ_Rouge\Assets\Scripts\CommandEvents\_NotClassified_\StartNewGameCommand.cs", "C#", 25, 0, 3, 4, 32
"d:\FileFolder\Life\Unity\Projects\PVZR\PVZ_Rouge\Assets\Scripts\CommandEvents\__NewlyAdded__\OpenLevelPreviewPanelCommand.cs", "C#", 25, 0, 2, 6, 33
"d:\FileFolder\Life\Unity\Projects\PVZR\PVZ_Rouge\Assets\Scripts\Docs\SortingLayer.md", "Markdown", 0, 43, 0, 9, 52
"d:\FileFolder\Life\Unity\Projects\PVZR\PVZ_Rouge\Assets\Scripts\Docs\Untitled.md", "Markdown", 0, 4, 0, 1, 5
"d:\FileFolder\Life\Unity\Projects\PVZR\PVZ_Rouge\Assets\Scripts\Docs\待办事项.md", "Markdown", 0, 64, 0, 7, 71
"d:\FileFolder\Life\Unity\Projects\PVZR\PVZ_Rouge\Assets\Scripts\Docs\我希望自己记住的东西.md", "Markdown", 0, 15, 0, 16, 31
"d:\FileFolder\Life\Unity\Projects\PVZR\PVZ_Rouge\Assets\Scripts\Docs\目前相对于原版做的创新.md", "Markdown", 0, 9, 0, 3, 12
"d:\FileFolder\Life\Unity\Projects\PVZR\PVZ_Rouge\Assets\Scripts\Helpers\ClassCreator\AttackCreator.cs", "C#", 13, 0, 0, 1, 14
"d:\FileFolder\Life\Unity\Projects\PVZR\PVZ_Rouge\Assets\Scripts\Helpers\ClassCreator\GameCreator.cs", "C#", 43, 0, 3, 6, 52
"d:\FileFolder\Life\Unity\Projects\PVZR\PVZ_Rouge\Assets\Scripts\Helpers\ClassCreator\ItemCreator.cs", "C#", 20, 0, 0, 2, 22
"d:\FileFolder\Life\Unity\Projects\PVZR\PVZ_Rouge\Assets\Scripts\Helpers\ClassCreator\LootCreator.cs", "C#", 65, 0, 0, 6, 71
"d:\FileFolder\Life\Unity\Projects\PVZR\PVZ_Rouge\Assets\Scripts\Helpers\ClassCreator\TombCreator.cs", "C#", 14, 0, 0, 1, 15
"d:\FileFolder\Life\Unity\Projects\PVZR\PVZ_Rouge\Assets\Scripts\Helpers\ClassCreator\TradeCreator.cs", "C#", 110, 0, 0, 16, 126
"d:\FileFolder\Life\Unity\Projects\PVZR\PVZ_Rouge\Assets\Scripts\Helpers\ClassCreator\ZombieArmorCreator.cs", "C#", 13, 0, 0, 1, 14
"d:\FileFolder\Life\Unity\Projects\PVZR\PVZ_Rouge\Assets\Scripts\Helpers\DataReader\AttackConfigReader.cs", "C#", 38, 0, 0, 9, 47
"d:\FileFolder\Life\Unity\Projects\PVZR\PVZ_Rouge\Assets\Scripts\Helpers\DataReader\GameConfigReader.cs", "C#", 74, 0, 3, 15, 92
"d:\FileFolder\Life\Unity\Projects\PVZR\PVZ_Rouge\Assets\Scripts\Helpers\DataReader\PlantBookConfigReader.cs", "C#", 40, 0, 0, 9, 49
"d:\FileFolder\Life\Unity\Projects\PVZR\PVZ_Rouge\Assets\Scripts\Helpers\DataReader\PlantConfigReader.cs", "C#", 55, 0, 2, 12, 69
"d:\FileFolder\Life\Unity\Projects\PVZR\PVZ_Rouge\Assets\Scripts\Helpers\DataReader\TradeConfigReader.cs", "C#", 179, 0, 9, 36, 224
"d:\FileFolder\Life\Unity\Projects\PVZR\PVZ_Rouge\Assets\Scripts\Helpers\DataReader\ZombieArmorConfigReader.cs", "C#", 39, 0, 1, 9, 49
"d:\FileFolder\Life\Unity\Projects\PVZR\PVZ_Rouge\Assets\Scripts\Helpers\GameObjectFactory\EntityFactory.cs", "C#", 195, 0, 3, 43, 241
"d:\FileFolder\Life\Unity\Projects\PVZR\PVZ_Rouge\Assets\Scripts\Helpers\GameObjectFactory\ItemViewFactory.cs", "C#", 68, 0, 0, 10, 78
"d:\FileFolder\Life\Unity\Projects\PVZR\PVZ_Rouge\Assets\Scripts\Helpers\GameObjectFactory\ShitFactory.cs", "C#", 43, 0, 0, 5, 48
"d:\FileFolder\Life\Unity\Projects\PVZR\PVZ_Rouge\Assets\Scripts\Helpers\Methods\EffectHelper.cs", "C#", 15, 0, 0, 1, 16
"d:\FileFolder\Life\Unity\Projects\PVZR\PVZ_Rouge\Assets\Scripts\Helpers\Methods\Global.cs", "C#", 9, 0, 0, 1, 10
"d:\FileFolder\Life\Unity\Projects\PVZR\PVZ_Rouge\Assets\Scripts\Helpers\Methods\HandHelper.cs", "C#", 34, 0, 1, 10, 45
"d:\FileFolder\Life\Unity\Projects\PVZR\PVZ_Rouge\Assets\Scripts\Helpers\Methods\LevelGridHelper.cs", "C#", 28, 0, 1, 4, 33
"d:\FileFolder\Life\Unity\Projects\PVZR\PVZ_Rouge\Assets\Scripts\Helpers\Methods\LevelMatrixHelper.cs", "C#", 53, 0, 1, 3, 57
"d:\FileFolder\Life\Unity\Projects\PVZR\PVZ_Rouge\Assets\Scripts\Helpers\NoticeHelper.cs", "C#", 8, 0, 3, 1, 12
"d:\FileFolder\Life\Unity\Projects\PVZR\PVZ_Rouge\Assets\Scripts\Helpers\PlantDefHelper.cs", "C#", 38, 0, 0, 4, 42
"d:\FileFolder\Life\Unity\Projects\PVZR\PVZ_Rouge\Assets\Scripts\Helpers\SeedH.cs", "C#", 24, 0, 6, 6, 36
"d:\FileFolder\Life\Unity\Projects\PVZR\PVZ_Rouge\Assets\Scripts\Models\GameModel.cs", "C#", 25, 0, 3, 6, 34
"d:\FileFolder\Life\Unity\Projects\PVZR\PVZ_Rouge\Assets\Scripts\Models\GamePhase.cs", "C#", 57, 0, 7, 11, 75
"d:\FileFolder\Life\Unity\Projects\PVZR\PVZ_Rouge\Assets\Scripts\Models\LevelGridModel.cs", "C#", 78, 0, 7, 15, 100
"d:\FileFolder\Life\Unity\Projects\PVZR\PVZ_Rouge\Assets\Scripts\Models\LevelModel.cs", "C#", 56, 0, 3, 14, 73
"d:\FileFolder\Life\Unity\Projects\PVZR\PVZ_Rouge\Assets\Scripts\Models\PhaseModel.cs", "C#", 101, 0, 16, 22, 139
"d:\FileFolder\Life\Unity\Projects\PVZR\PVZ_Rouge\Assets\Scripts\PVZRouge.cs", "C#", 36, 0, 3, 3, 42
"d:\FileFolder\Life\Unity\Projects\PVZR\PVZ_Rouge\Assets\Scripts\Systems\GameSystem.cs", "C#", 53, 0, 3, 6, 62
"d:\FileFolder\Life\Unity\Projects\PVZR\PVZ_Rouge\Assets\Scripts\Systems\InventorySystem.cs", "C#", 47, 0, 0, 7, 54
"d:\FileFolder\Life\Unity\Projects\PVZR\PVZ_Rouge\Assets\Scripts\Systems\Level_Data\HandSystem.cs", "C#", 65, 0, 4, 17, 86
"d:\FileFolder\Life\Unity\Projects\PVZR\PVZ_Rouge\Assets\Scripts\Systems\Level_Data\LevelSystem.cs", "C#", 155, 0, 7, 15, 177
"d:\FileFolder\Life\Unity\Projects\PVZR\PVZ_Rouge\Assets\Scripts\Systems\Level_Data\SeedSystem.cs", "C#", 53, 0, 3, 10, 66
"d:\FileFolder\Life\Unity\Projects\PVZR\PVZ_Rouge\Assets\Scripts\Systems\Level_Data\SunSystem.cs", "C#", 21, 0, 0, 4, 25
"d:\FileFolder\Life\Unity\Projects\PVZR\PVZ_Rouge\Assets\Scripts\Systems\Level_Data\ZombieAISystem.cs", "C#", 90, 0, 6, 14, 110
"d:\FileFolder\Life\Unity\Projects\PVZR\PVZ_Rouge\Assets\Scripts\Systems\Level_Event\EnvironmentSystem.cs", "C#", 61, 0, 0, 14, 75
"d:\FileFolder\Life\Unity\Projects\PVZR\PVZ_Rouge\Assets\Scripts\Systems\Level_Event\WaveSystem.cs", "C#", 60, 0, 0, 12, 72
"d:\FileFolder\Life\Unity\Projects\PVZR\PVZ_Rouge\Assets\Scripts\Systems\Level_Event\ZombieSpawnSystem.cs", "C#", 89, 0, 0, 14, 103
"d:\FileFolder\Life\Unity\Projects\PVZR\PVZ_Rouge\Assets\Scripts\Systems\MainGameSystem.cs", "C#", 51, 0, 1, 4, 56
"d:\FileFolder\Life\Unity\Projects\PVZR\PVZ_Rouge\Assets\Scripts\Systems\MazeMap\AwardSystem.cs", "C#", 95, 0, 1, 19, 115
"d:\FileFolder\Life\Unity\Projects\PVZR\PVZ_Rouge\Assets\Scripts\Systems\MazeMap\CoinStoreSystem.cs", "C#", 86, 0, 2, 20, 108
"d:\FileFolder\Life\Unity\Projects\PVZR\PVZ_Rouge\Assets\Scripts\Systems\MazeMap\MazeMapSystem.cs", "C#", 114, 0, 8, 17, 139
"d:\FileFolder\Life\Unity\Projects\PVZR\PVZ_Rouge\Assets\Scripts\Systems\MazeMap\RecipeStoreSystem.cs", "C#", 85, 0, 2, 14, 101
"d:\FileFolder\Life\Unity\Projects\PVZR\PVZ_Rouge\Assets\Scripts\Systems\MazeMap\SellStoreSystem.cs", "C#", 97, 0, 3, 20, 120
"d:\FileFolder\Life\Unity\Projects\PVZR\PVZ_Rouge\Assets\Scripts\Systems\SaveSystem.cs", "C#", 51, 0, 0, 8, 59
"d:\FileFolder\Life\Unity\Projects\PVZR\PVZ_Rouge\Assets\Scripts\Tools\Attributes.cs", "C#", 10, 0, 0, 1, 11
"d:\FileFolder\Life\Unity\Projects\PVZR\PVZ_Rouge\Assets\Scripts\Tools\CollisionDetector.cs", "C#", 30, 0, 2, 5, 37
"d:\FileFolder\Life\Unity\Projects\PVZR\PVZ_Rouge\Assets\Scripts\Tools\Enums.cs", "C#", 24, 0, 0, 4, 28
"d:\FileFolder\Life\Unity\Projects\PVZR\PVZ_Rouge\Assets\Scripts\Tools\Extensions.cs", "C#", 63, 0, 22, 14, 99
"d:\FileFolder\Life\Unity\Projects\PVZR\PVZ_Rouge\Assets\Scripts\Tools\Matrix.cs", "C#", 167, 0, 76, 42, 285
"d:\FileFolder\Life\Unity\Projects\PVZR\PVZ_Rouge\Assets\Scripts\Tools\PriorityQueue\FastPriorityQueue.cs", "C#", 438, 0, 106, 48, 592
"d:\FileFolder\Life\Unity\Projects\PVZR\PVZ_Rouge\Assets\Scripts\Tools\PriorityQueue\FastPriorityQueueNode.cs", "C#", 11, 0, 10, 3, 24
"d:\FileFolder\Life\Unity\Projects\PVZR\PVZ_Rouge\Assets\Scripts\Tools\PriorityQueue\IFixedSizePriorityQueue.cs", "C#", 9, 0, 15, 3, 27
"d:\FileFolder\Life\Unity\Projects\PVZR\PVZ_Rouge\Assets\Scripts\Tools\PriorityQueue\IPriorityQueue.cs", "C#", 15, 0, 30, 9, 54
"d:\FileFolder\Life\Unity\Projects\PVZR\PVZ_Rouge\Assets\Scripts\Tools\RandomPool.cs", "C#", 144, 0, 12, 36, 192
"d:\FileFolder\Life\Unity\Projects\PVZR\PVZ_Rouge\Assets\Scripts\Tools\Random\DeterministicRandom.cs", "C#", 154, 0, 68, 39, 261
"d:\FileFolder\Life\Unity\Projects\PVZR\PVZ_Rouge\Assets\Scripts\Tools\Random\RandomHelper.cs", "C#", 14, 0, 0, 4, 18
"d:\FileFolder\Life\Unity\Projects\PVZR\PVZ_Rouge\Assets\Scripts\Tools\Save\GameDataSave.cs", "C#", 67, 0, 0, 10, 77
"d:\FileFolder\Life\Unity\Projects\PVZR\PVZ_Rouge\Assets\Scripts\Tools\Save\ISavable.cs", "C#", 10, 0, 0, 2, 12
"d:\FileFolder\Life\Unity\Projects\PVZR\PVZ_Rouge\Assets\Scripts\Tools\Save\SaveHelper.cs", "C#", 87, 0, 20, 15, 122
"d:\FileFolder\Life\Unity\Projects\PVZR\PVZ_Rouge\Assets\Scripts\Tools\Timer.cs", "C#", 74, 0, 2, 14, 90
"d:\FileFolder\Life\Unity\Projects\PVZR\PVZ_Rouge\Assets\Scripts\ViewControllers\Entities\EntityBase\Entity.cs", "C#", 53, 0, 9, 16, 78
"d:\FileFolder\Life\Unity\Projects\PVZR\PVZ_Rouge\Assets\Scripts\ViewControllers\Entities\EntityBase\Interfaces\IAttackable.cs", "C#", 14, 0, 10, 3, 27
"d:\FileFolder\Life\Unity\Projects\PVZR\PVZ_Rouge\Assets\Scripts\ViewControllers\Entities\EntityBase\Interfaces\IEffectable.cs", "C#", 8, 0, 0, 1, 9
"d:\FileFolder\Life\Unity\Projects\PVZR\PVZ_Rouge\Assets\Scripts\ViewControllers\Entities\EntityBase\Interfaces\IEntity.cs", "C#", 10, 0, 0, 1, 11
"d:\FileFolder\Life\Unity\Projects\PVZR\PVZ_Rouge\Assets\Scripts\ViewControllers\Entities\Plants\Base\IPlant.cs", "C#", 14, 0, 0, 2, 16
"d:\FileFolder\Life\Unity\Projects\PVZR\PVZ_Rouge\Assets\Scripts\ViewControllers\Entities\Plants\Base\Plant.cs", "C#", 52, 0, 3, 18, 73
"d:\FileFolder\Life\Unity\Projects\PVZR\PVZ_Rouge\Assets\Scripts\ViewControllers\Entities\Plants\Cactus.cs", "C#", 43, 0, 1, 8, 52
"d:\FileFolder\Life\Unity\Projects\PVZR\PVZ_Rouge\Assets\Scripts\ViewControllers\Entities\Plants\CherryBomb.cs", "C#", 37, 0, 0, 5, 42
"d:\FileFolder\Life\Unity\Projects\PVZR\PVZ_Rouge\Assets\Scripts\ViewControllers\Entities\Plants\Flowerpot.cs", "C#", 34, 0, 0, 4, 38
"d:\FileFolder\Life\Unity\Projects\PVZR\PVZ_Rouge\Assets\Scripts\ViewControllers\Entities\Plants\Marigold.cs", "C#", 37, 0, 0, 8, 45
"d:\FileFolder\Life\Unity\Projects\PVZR\PVZ_Rouge\Assets\Scripts\ViewControllers\Entities\Plants\MungBeanShooter.cs", "C#", 47, 0, 2, 9, 58
"d:\FileFolder\Life\Unity\Projects\PVZR\PVZ_Rouge\Assets\Scripts\ViewControllers\Entities\Plants\Peashooter.cs", "C#", 44, 0, 1, 8, 53
"d:\FileFolder\Life\Unity\Projects\PVZR\PVZ_Rouge\Assets\Scripts\ViewControllers\Entities\Plants\PotatoMine.cs", "C#", 58, 0, 0, 10, 68
"d:\FileFolder\Life\Unity\Projects\PVZR\PVZ_Rouge\Assets\Scripts\ViewControllers\Entities\Plants\Repeater.cs", "C#", 51, 0, 1, 9, 61
"d:\FileFolder\Life\Unity\Projects\PVZR\PVZ_Rouge\Assets\Scripts\ViewControllers\Entities\Plants\SnowPea.cs", "C#", 43, 0, 1, 9, 53
"d:\FileFolder\Life\Unity\Projects\PVZR\PVZ_Rouge\Assets\Scripts\ViewControllers\Entities\Plants\SplitPea.cs", "C#", 62, 0, 1, 12, 75
"d:\FileFolder\Life\Unity\Projects\PVZR\PVZ_Rouge\Assets\Scripts\ViewControllers\Entities\Plants\Sunflower.cs", "C#", 34, 0, 0, 8, 42
"d:\FileFolder\Life\Unity\Projects\PVZR\PVZ_Rouge\Assets\Scripts\ViewControllers\Entities\Plants\Wallnut.cs", "C#", 15, 0, 0, 2, 17
"d:\FileFolder\Life\Unity\Projects\PVZR\PVZ_Rouge\Assets\Scripts\ViewControllers\Entities\Projectiles\FrozenPea.cs", "C#", 30, 0, 0, 5, 35
"d:\FileFolder\Life\Unity\Projects\PVZR\PVZ_Rouge\Assets\Scripts\ViewControllers\Entities\Projectiles\IPeaLikeInit.cs", "C#", 8, 0, 0, 1, 9
"d:\FileFolder\Life\Unity\Projects\PVZR\PVZ_Rouge\Assets\Scripts\ViewControllers\Entities\Projectiles\IProjectile.cs", "C#", 7, 0, 0, 1, 8
"d:\FileFolder\Life\Unity\Projects\PVZR\PVZ_Rouge\Assets\Scripts\ViewControllers\Entities\Projectiles\MungBean.cs", "C#", 30, 0, 0, 5, 35
"d:\FileFolder\Life\Unity\Projects\PVZR\PVZ_Rouge\Assets\Scripts\ViewControllers\Entities\Projectiles\Pea.cs", "C#", 30, 0, 0, 5, 35
"d:\FileFolder\Life\Unity\Projects\PVZR\PVZ_Rouge\Assets\Scripts\ViewControllers\Entities\Projectiles\Projectile.cs", "C#", 14, 0, 0, 2, 16
"d:\FileFolder\Life\Unity\Projects\PVZR\PVZ_Rouge\Assets\Scripts\ViewControllers\Entities\Projectiles\Spike.cs", "C#", 33, 0, 0, 4, 37
"d:\FileFolder\Life\Unity\Projects\PVZR\PVZ_Rouge\Assets\Scripts\ViewControllers\Entities\Zombies\Base\IZombie.cs", "C#", 7, 0, 0, 1, 8
"d:\FileFolder\Life\Unity\Projects\PVZR\PVZ_Rouge\Assets\Scripts\ViewControllers\Entities\Zombies\Base\Zombie.cs", "C#", 322, 0, 21, 86, 429
"d:\FileFolder\Life\Unity\Projects\PVZR\PVZ_Rouge\Assets\Scripts\ViewControllers\Entities\Zombies\Instances\BucketheadZombie.cs", "C#", 28, 0, 0, 6, 34
"d:\FileFolder\Life\Unity\Projects\PVZR\PVZ_Rouge\Assets\Scripts\ViewControllers\Entities\Zombies\Instances\ConeheadZombie.cs", "C#", 28, 0, 0, 6, 34
"d:\FileFolder\Life\Unity\Projects\PVZR\PVZ_Rouge\Assets\Scripts\ViewControllers\Entities\Zombies\Instances\NewspaperZombie.cs", "C#", 41, 0, 0, 11, 52
"d:\FileFolder\Life\Unity\Projects\PVZR\PVZ_Rouge\Assets\Scripts\ViewControllers\Entities\Zombies\Instances\NormalZombie.cs", "C#", 17, 0, 0, 2, 19
"d:\FileFolder\Life\Unity\Projects\PVZR\PVZ_Rouge\Assets\Scripts\ViewControllers\Entities\Zombies\Instances\ScreenDoorZombie.cs", "C#", 29, 0, 0, 7, 36
"d:\FileFolder\Life\Unity\Projects\PVZR\PVZ_Rouge\Assets\Scripts\ViewControllers\Entities\Zombies\States\AttackingState.cs", "C#", 39, 0, 0, 6, 45
"d:\FileFolder\Life\Unity\Projects\PVZR\PVZ_Rouge\Assets\Scripts\ViewControllers\Entities\Zombies\States\DefaultTargetingState.cs", "C#", 48, 0, 5, 8, 61
"d:\FileFolder\Life\Unity\Projects\PVZR\PVZ_Rouge\Assets\Scripts\ViewControllers\Entities\Zombies\States\OnNewspaperDestroyed.cs", "C#", 16, 0, 0, 2, 18
"d:\FileFolder\Life\Unity\Projects\PVZR\PVZ_Rouge\Assets\Scripts\ViewControllers\Entities\Zombies\States\ZombieState.cs", "C#", 10, 0, 0, 0, 10
"d:\FileFolder\Life\Unity\Projects\PVZR\PVZ_Rouge\Assets\Scripts\ViewControllers\Entities\Zombies\View\Components\ZombieArmorView.cs", "C#", 33, 0, 0, 2, 35
"d:\FileFolder\Life\Unity\Projects\PVZR\PVZ_Rouge\Assets\Scripts\ViewControllers\Entities\Zombies\View\Components\ZombieComponentView.cs", "C#", 29, 0, 0, 5, 34
"d:\FileFolder\Life\Unity\Projects\PVZR\PVZ_Rouge\Assets\Scripts\ViewControllers\Entities\Zombies\View\ViewController\DefaultZombieViewController.cs", "C#", 59, 0, 5, 7, 71
"d:\FileFolder\Life\Unity\Projects\PVZR\PVZ_Rouge\Assets\Scripts\ViewControllers\Entities\Zombies\View\ViewController\NewspaperZombieViewController.cs", "C#", 67, 0, 6, 9, 82
"d:\FileFolder\Life\Unity\Projects\PVZR\PVZ_Rouge\Assets\Scripts\ViewControllers\Entities\Zombies\View\ViewController\ZombieViewController.cs", "C#", 63, 0, 4, 21, 88
"d:\FileFolder\Life\Unity\Projects\PVZR\PVZ_Rouge\Assets\Scripts\ViewControllers\Entities\Zombies\ZombieAttackAreaController.cs", "C#", 24, 0, 0, 2, 26
"d:\FileFolder\Life\Unity\Projects\PVZR\PVZ_Rouge\Assets\Scripts\ViewControllers\Entities\Zombies\ZombieShieldController.cs", "C#", 26, 0, 0, 5, 31
"d:\FileFolder\Life\Unity\Projects\PVZR\PVZ_Rouge\Assets\Scripts\ViewControllers\Managers\GameManager.cs", "C#", 102, 0, 1, 18, 121
"d:\FileFolder\Life\Unity\Projects\PVZR\PVZ_Rouge\Assets\Scripts\ViewControllers\Managers\GameStarter.cs", "C#", 24, 0, 6, 3, 33
"d:\FileFolder\Life\Unity\Projects\PVZR\PVZ_Rouge\Assets\Scripts\ViewControllers\Managers\SomeInputController.cs", "C#", 145, 0, 6, 18, 169
"d:\FileFolder\Life\Unity\Projects\PVZR\PVZ_Rouge\Assets\Scripts\ViewControllers\Managers\TestDataManager.cs", "C#", 11, 0, 0, 2, 13
"d:\FileFolder\Life\Unity\Projects\PVZR\PVZ_Rouge\Assets\Scripts\ViewControllers\Others\Coin.cs", "C#", 49, 0, 0, 10, 59
"d:\FileFolder\Life\Unity\Projects\PVZR\PVZ_Rouge\Assets\Scripts\ViewControllers\Others\InteractionPromptController.cs", "C#", 26, 0, 0, 5, 31
"d:\FileFolder\Life\Unity\Projects\PVZR\PVZ_Rouge\Assets\Scripts\ViewControllers\Others\LevelEndObjectController.cs", "C#", 62, 0, 3, 13, 78
"d:\FileFolder\Life\Unity\Projects\PVZR\PVZ_Rouge\Assets\Scripts\ViewControllers\Others\LevelScene\FollowingImage.cs", "C#", 64, 0, 3, 9, 76
"d:\FileFolder\Life\Unity\Projects\PVZR\PVZ_Rouge\Assets\Scripts\ViewControllers\Others\LevelScene\LevelTilemapController.cs", "C#", 20, 0, 0, 3, 23
"d:\FileFolder\Life\Unity\Projects\PVZR\PVZ_Rouge\Assets\Scripts\ViewControllers\Others\LevelScene\ParallaxController.cs", "C#", 49, 0, 2, 10, 61
"d:\FileFolder\Life\Unity\Projects\PVZR\PVZ_Rouge\Assets\Scripts\ViewControllers\Others\LevelScene\SelectFramebox.cs", "C#", 75, 0, 0, 9, 84
"d:\FileFolder\Life\Unity\Projects\PVZR\PVZ_Rouge\Assets\Scripts\ViewControllers\Others\LevelScene\VirtualCamaraController.cs", "C#", 50, 0, 0, 7, 57
"d:\FileFolder\Life\Unity\Projects\PVZR\PVZ_Rouge\Assets\Scripts\ViewControllers\Others\MazeMap\MazeMapTilemapController.cs", "C#", 14, 0, 0, 3, 17
"d:\FileFolder\Life\Unity\Projects\PVZR\PVZ_Rouge\Assets\Scripts\ViewControllers\Others\MazeMap\TempEndGameObjectController.cs", "C#", 18, 0, 0, 2, 20
"d:\FileFolder\Life\Unity\Projects\PVZR\PVZ_Rouge\Assets\Scripts\ViewControllers\Others\MazeMap\TombstoneController.cs", "C#", 47, 0, 0, 9, 56
"d:\FileFolder\Life\Unity\Projects\PVZR\PVZ_Rouge\Assets\Scripts\ViewControllers\Others\Player.cs", "C#", 106, 0, 3, 26, 135
"d:\FileFolder\Life\Unity\Projects\PVZR\PVZ_Rouge\Assets\Scripts\ViewControllers\Others\Sun.cs", "C#", 44, 0, 0, 9, 53
"d:\FileFolder\Life\Unity\Projects\PVZR\PVZ_Rouge\Assets\Scripts\ViewControllers\UI\ItemView\CardViewController.cs", "C#", 54, 0, 0, 8, 62
"d:\FileFolder\Life\Unity\Projects\PVZR\PVZ_Rouge\Assets\Scripts\ViewControllers\UI\ItemView\CoinViewController.cs", "C#", 13, 0, 0, 2, 15
"d:\FileFolder\Life\Unity\Projects\PVZR\PVZ_Rouge\Assets\Scripts\ViewControllers\UI\ItemView\PlantBookViewController.cs", "C#", 21, 0, 0, 4, 25
"d:\FileFolder\Life\Unity\Projects\PVZR\PVZ_Rouge\Assets\Scripts\ViewControllers\UI\LevelScene\LevelStateBarPanelController.cs", "C#", 58, 0, 2, 10, 70
"d:\FileFolder\Life\Unity\Projects\PVZR\PVZ_Rouge\Assets\Scripts\ViewControllers\UI\LevelScene\SeedController.cs", "C#", 134, 0, 4, 22, 160
"d:\FileFolder\Life\Unity\Projects\PVZR\PVZ_Rouge\Assets\Scripts\ViewControllers\UI\LevelScene\SeedOptionController.cs", "C#", 50, 0, 0, 7, 57
"d:\FileFolder\Life\Unity\Projects\PVZR\PVZ_Rouge\Assets\Scripts\ViewControllers\UI\LevelScene\ShovelController.cs", "C#", 54, 0, 0, 6, 60
"d:\FileFolder\Life\Unity\Projects\PVZR\PVZ_Rouge\Assets\Scripts\ViewControllers\UI\LevelScene\SunpointController.cs", "C#", 24, 0, 0, 8, 32
"d:\FileFolder\Life\Unity\Projects\PVZR\PVZ_Rouge\Assets\Scripts\ViewControllers\UI\MazeMapScene\AwardPanelController.cs", "C#", 76, 0, 5, 15, 96
"d:\FileFolder\Life\Unity\Projects\PVZR\PVZ_Rouge\Assets\Scripts\ViewControllers\UI\MazeMapScene\CardPanelController.cs", "C#", 48, 0, 2, 10, 60
"d:\FileFolder\Life\Unity\Projects\PVZR\PVZ_Rouge\Assets\Scripts\ViewControllers\UI\MazeMapScene\CoinStorePanelController.cs", "C#", 137, 0, 12, 26, 175
"d:\FileFolder\Life\Unity\Projects\PVZR\PVZ_Rouge\Assets\Scripts\ViewControllers\UI\MazeMapScene\CoinTradeNode.cs", "C#", 12, 0, 0, 1, 13
"d:\FileFolder\Life\Unity\Projects\PVZR\PVZ_Rouge\Assets\Scripts\ViewControllers\UI\MazeMapScene\InventoryPanelController.cs", "C#", 38, 0, 0, 8, 46
"d:\FileFolder\Life\Unity\Projects\PVZR\PVZ_Rouge\Assets\Scripts\ViewControllers\UI\MazeMapScene\MazeMapPanelController.cs", "C#", 76, 0, 2, 18, 96
"d:\FileFolder\Life\Unity\Projects\PVZR\PVZ_Rouge\Assets\Scripts\ViewControllers\UI\MazeMapScene\PlantBookPanelController.cs", "C#", 38, 0, 2, 9, 49
"d:\FileFolder\Life\Unity\Projects\PVZR\PVZ_Rouge\Assets\Scripts\ViewControllers\UI\MazeMapScene\RecipeStorePanelController.cs", "C#", 105, 0, 11, 17, 133
"d:\FileFolder\Life\Unity\Projects\PVZR\PVZ_Rouge\Assets\Scripts\ViewControllers\UI\MazeMapScene\RecipeTradeNode.cs", "C#", 12, 0, 0, 1, 13
"d:\FileFolder\Life\Unity\Projects\PVZR\PVZ_Rouge\Assets\Scripts\ViewControllers\UI\MazeMapScene\SellTradePanelController.cs", "C#", 97, 0, 6, 14, 117
"d:\FileFolder\Life\Unity\Projects\PVZR\PVZ_Rouge\Assets\Scripts\ViewControllers\UI\MazeMapScene\StorePanelController.cs", "C#", 29, 0, 0, 5, 34
"d:\FileFolder\Life\Unity\Projects\PVZR\PVZ_Rouge\Assets\Scripts\ViewControllers\UI\Panels\UIChooseSeedPanel.Designer.cs", "C#", 44, 0, 1, 8, 53
"d:\FileFolder\Life\Unity\Projects\PVZR\PVZ_Rouge\Assets\Scripts\ViewControllers\UI\Panels\UIChooseSeedPanel.cs", "C#", 102, 0, 7, 21, 130
"d:\FileFolder\Life\Unity\Projects\PVZR\PVZ_Rouge\Assets\Scripts\ViewControllers\UI\Panels\UIGameStartPanel.Designer.cs", "C#", 44, 0, 1, 8, 53
"d:\FileFolder\Life\Unity\Projects\PVZR\PVZ_Rouge\Assets\Scripts\ViewControllers\UI\Panels\UIGameStartPanel.cs", "C#", 71, 0, 1, 12, 84
"d:\FileFolder\Life\Unity\Projects\PVZR\PVZ_Rouge\Assets\Scripts\ViewControllers\UI\Panels\UILevelGameplayPanel.Designer.cs", "C#", 47, 0, 1, 8, 56
"d:\FileFolder\Life\Unity\Projects\PVZR\PVZ_Rouge\Assets\Scripts\ViewControllers\UI\Panels\UILevelGameplayPanel.cs", "C#", 133, 0, 4, 28, 165
"d:\FileFolder\Life\Unity\Projects\PVZR\PVZ_Rouge\Assets\Scripts\ViewControllers\UI\Panels\UIMazeMapPanel.Designer.cs", "C#", 50, 0, 1, 8, 59
"d:\FileFolder\Life\Unity\Projects\PVZR\PVZ_Rouge\Assets\Scripts\ViewControllers\UI\Panels\UIMazeMapPanel.cs", "C#", 45, 0, 4, 11, 60
"Total", "-", 13227, 135, 1108, 2543, 17013