"filename", "language", "C#", "Markdown", "comment", "blank", "total"
"d:\FileFolder\Life\Unity\Projects\PVZR\PVZ_Rouge\Assets\Scripts\Classes\DataClasses\GlobalEntityData.cs", "C#", 1, 0, 0, 0, 1
"d:\FileFolder\Life\Unity\Projects\PVZR\PVZ_Rouge\Assets\Scripts\Classes\DataClasses\InventoryData.cs", "C#", 20, 0, 0, 6, 26
"d:\FileFolder\Life\Unity\Projects\PVZR\PVZ_Rouge\Assets\Scripts\Classes\DataClasses\Item\Card\CardQuality.cs", "C#", -15, 0, 0, -1, -16
"d:\FileFolder\Life\Unity\Projects\PVZR\PVZ_Rouge\Assets\Scripts\Classes\DataClasses\Item\PlantBook\PlantBookData.cs", "C#", 1, 0, 0, 0, 1
"d:\FileFolder\Life\Unity\Projects\PVZR\PVZ_Rouge\Assets\Scripts\Classes\DataClasses\Item\PlantBook\PlantBookDefinition.cs", "C#", 1, 0, 0, 0, 1
"d:\FileFolder\Life\Unity\Projects\PVZR\PVZ_Rouge\Assets\Scripts\Classes\DataClasses\Level\LevelData.cs", "C#", 20, 0, 2, 4, 26
"d:\FileFolder\Life\Unity\Projects\PVZR\PVZ_Rouge\Assets\Scripts\Classes\DataClasses\Level\LevelDef.cs", "C#", 35, 0, 0, 7, 42
"d:\FileFolder\Life\Unity\Projects\PVZR\PVZ_Rouge\Assets\Scripts\Classes\DataClasses\Level\LevelDefinition.cs", "C#", 3, 0, 0, 1, 4
"d:\FileFolder\Life\Unity\Projects\PVZR\PVZ_Rouge\Assets\Scripts\Classes\DataClasses\Level\LevelId.cs", "C#", 2, 0, 0, 1, 3
"d:\FileFolder\Life\Unity\Projects\PVZR\PVZ_Rouge\Assets\Scripts\Classes\DataClasses\Loot\LootData.cs", "C#", 2, 0, 0, 0, 2
"d:\FileFolder\Life\Unity\Projects\PVZR\PVZ_Rouge\Assets\Scripts\Classes\DataClasses\Loot\LootType.cs", "C#", 1, 0, 0, 0, 1
"d:\FileFolder\Life\Unity\Projects\PVZR\PVZ_Rouge\Assets\Scripts\Classes\DataClasses_InLevel\Effect\EffectGroup.cs", "C#", 7, 0, 4, 1, 12
"d:\FileFolder\Life\Unity\Projects\PVZR\PVZ_Rouge\Assets\Scripts\Classes\MazeMap\MazeMapData.cs", "C#", -2, 0, 0, 0, -2
"d:\FileFolder\Life\Unity\Projects\PVZR\PVZ_Rouge\Assets\Scripts\Classes\MazeMap\MazeMapDef.cs", "C#", 34, 0, 0, 7, 41
"d:\FileFolder\Life\Unity\Projects\PVZR\PVZ_Rouge\Assets\Scripts\Classes\MazeMap\MazeMapDefinition.cs", "C#", -1, 0, 0, 0, -1
"d:\FileFolder\Life\Unity\Projects\PVZR\PVZ_Rouge\Assets\Scripts\Classes\ZombieAI\PathFinding\ZombieAIUnit.cs", "C#", 1, 0, 0, 0, 1
"d:\FileFolder\Life\Unity\Projects\PVZR\PVZ_Rouge\Assets\Scripts\CommandEvents\Level_ChooseSeeds\ChooseSeedCommand.cs", "C#", 2, 0, 0, 0, 2
"d:\FileFolder\Life\Unity\Projects\PVZR\PVZ_Rouge\Assets\Scripts\CommandEvents\Level_ChooseSeeds\UnchooseSeedCommand.cs", "C#", 2, 0, 0, 1, 3
"d:\FileFolder\Life\Unity\Projects\PVZR\PVZ_Rouge\Assets\Scripts\CommandEvents\__NewlyAdded__\CoinStoreRefreshCommand.cs", "C#", 22, 0, 2, 4, 28
"d:\FileFolder\Life\Unity\Projects\PVZR\PVZ_Rouge\Assets\Scripts\Docs\待办事项.md", "Markdown", 0, 6, 0, -19, -13
"d:\FileFolder\Life\Unity\Projects\PVZR\PVZ_Rouge\Assets\Scripts\Helpers\ClassCreator\GameCreator.cs", "C#", 1, 0, 0, 0, 1
"d:\FileFolder\Life\Unity\Projects\PVZR\PVZ_Rouge\Assets\Scripts\Helpers\ClassCreator\LootCreator.cs", "C#", 4, 0, 0, 1, 5
"d:\FileFolder\Life\Unity\Projects\PVZR\PVZ_Rouge\Assets\Scripts\Helpers\ClassCreator\TradeCreator.cs", "C#", 12, 0, 0, 1, 13
"d:\FileFolder\Life\Unity\Projects\PVZR\PVZ_Rouge\Assets\Scripts\Helpers\DataReader\TradeConfigReader.cs", "C#", 31, 0, 1, 6, 38
"d:\FileFolder\Life\Unity\Projects\PVZR\PVZ_Rouge\Assets\Scripts\Helpers\GameObjectFactory\ItemViewFactory.cs", "C#", 7, 0, 0, 1, 8
"d:\FileFolder\Life\Unity\Projects\PVZR\PVZ_Rouge\Assets\Scripts\Helpers\GameObjectFactory\ShitFactory.cs", "C#", 1, 0, 0, 0, 1
"d:\FileFolder\Life\Unity\Projects\PVZR\PVZ_Rouge\Assets\Scripts\Helpers\Methods\HandHelper.cs", "C#", 1, 0, 0, 0, 1
"d:\FileFolder\Life\Unity\Projects\PVZR\PVZ_Rouge\Assets\Scripts\Helpers\Methods\LevelGridHelper.cs", "C#", 1, 0, 0, 0, 1
"d:\FileFolder\Life\Unity\Projects\PVZR\PVZ_Rouge\Assets\Scripts\Models\LevelGridModel.cs", "C#", 3, 0, 0, 0, 3
"d:\FileFolder\Life\Unity\Projects\PVZR\PVZ_Rouge\Assets\Scripts\Systems\Level_Data\LevelSystem.cs", "C#", -4, 0, 0, 0, -4
"d:\FileFolder\Life\Unity\Projects\PVZR\PVZ_Rouge\Assets\Scripts\Systems\Level_Data\ZombieAISystem.cs", "C#", 1, 0, 0, 0, 1
"d:\FileFolder\Life\Unity\Projects\PVZR\PVZ_Rouge\Assets\Scripts\Systems\MazeMap\CoinStoreSystem.cs", "C#", 18, 0, 0, 5, 23
"d:\FileFolder\Life\Unity\Projects\PVZR\PVZ_Rouge\Assets\Scripts\Tools\ReferenceHelper.cs", "C#", -17, 0, 0, -1, -18
"d:\FileFolder\Life\Unity\Projects\PVZR\PVZ_Rouge\Assets\Scripts\ViewControllers\Entities\Projectiles\Spike.cs", "C#", 1, 0, 0, 0, 1
"d:\FileFolder\Life\Unity\Projects\PVZR\PVZ_Rouge\Assets\Scripts\ViewControllers\Entities\Zombies\States\AttackingState.cs", "C#", -1, 0, 0, 0, -1
"d:\FileFolder\Life\Unity\Projects\PVZR\PVZ_Rouge\Assets\Scripts\ViewControllers\Entities\Zombies\States\DefaultTargetingState.cs", "C#", -1, 0, 0, 0, -1
"d:\FileFolder\Life\Unity\Projects\PVZR\PVZ_Rouge\Assets\Scripts\ViewControllers\Managers\GameManager.cs", "C#", 16, 0, 0, 2, 18
"d:\FileFolder\Life\Unity\Projects\PVZR\PVZ_Rouge\Assets\Scripts\ViewControllers\Others\LevelScene\LevelTilemapController.cs", "C#", 1, 0, 0, 1, 2
"d:\FileFolder\Life\Unity\Projects\PVZR\PVZ_Rouge\Assets\Scripts\ViewControllers\Others\UI\MazeMap\CardPanelController.cs", "C#", 48, 0, 2, 10, 60
"d:\FileFolder\Life\Unity\Projects\PVZR\PVZ_Rouge\Assets\Scripts\ViewControllers\Others\UI\MazeMap\CoinStorePanelController.cs", "C#", 62, 0, 6, 11, 79
"d:\FileFolder\Life\Unity\Projects\PVZR\PVZ_Rouge\Assets\Scripts\ViewControllers\Others\UI\MazeMap\InventoryPanelController.cs", "C#", -20, 0, -2, -3, -25
"d:\FileFolder\Life\Unity\Projects\PVZR\PVZ_Rouge\Assets\Scripts\ViewControllers\Others\UI\MazeMap\PlantBookPanelController.cs", "C#", 38, 0, 2, 9, 49
"d:\FileFolder\Life\Unity\Projects\PVZR\PVZ_Rouge\Assets\Scripts\ViewControllers\Others\UI\SeedController.cs", "C#", -2, 0, 0, 0, -2
"d:\FileFolder\Life\Unity\Projects\PVZR\PVZ_Rouge\Assets\Scripts\ViewControllers\Others\UI\SeedOptionController.cs", "C#", 3, 0, 0, 0, 3
"d:\FileFolder\Life\Unity\Projects\PVZR\PVZ_Rouge\Assets\Scripts\ViewControllers\Player.cs", "C#", 1, 0, 0, -2, -1
"d:\FileFolder\Life\Unity\Projects\PVZR\PVZ_Rouge\Assets\Scripts\ViewControllers\UI\UIChooseSeedPanel.cs", "C#", -1, 0, 0, 0, -1
"d:\FileFolder\Life\Unity\Projects\PVZR\PVZ_Rouge\Assets\Scripts\ViewControllers\UI\UILevelGameplayPanel.cs", "C#", 31, 0, 0, 3, 34
"Total", "-", 371, 6, 17, 56, 450