"filename", "language", "C#", "Markdown", "comment", "blank", "total"
"d:\FileFolder\Life\Unity\Projects\PVZR\PVZ_Rouge\Assets\Scripts\Classes\ConfigLists\AttackDefinitionList.cs", "C#", 12, 0, 0, 2, 14
"d:\FileFolder\Life\Unity\Projects\PVZR\PVZ_Rouge\Assets\Scripts\Classes\ConfigLists\GameDefinitionList.cs", "C#", 18, 0, 0, 2, 20
"d:\FileFolder\Life\Unity\Projects\PVZR\PVZ_Rouge\Assets\Scripts\Classes\ConfigLists\ItemValueList.cs", "C#", 11, 0, 0, 1, 12
"d:\FileFolder\Life\Unity\Projects\PVZR\PVZ_Rouge\Assets\Scripts\Classes\ConfigLists\LevelDefinitionList.cs", "C#", 12, 0, 0, 1, 13
"d:\FileFolder\Life\Unity\Projects\PVZR\PVZ_Rouge\Assets\Scripts\Classes\ConfigLists\MazeMapDefinitionList.cs", "C#", 18, 0, 0, 2, 20
"d:\FileFolder\Life\Unity\Projects\PVZR\PVZ_Rouge\Assets\Scripts\Classes\ConfigLists\PlantBookDefinitionList.cs", "C#", 18, 0, 0, 2, 20
"d:\FileFolder\Life\Unity\Projects\PVZR\PVZ_Rouge\Assets\Scripts\Classes\ConfigLists\PlantConfigList.cs", "C#", 23, 0, 0, 3, 26
"d:\FileFolder\Life\Unity\Projects\PVZR\PVZ_Rouge\Assets\Scripts\Classes\ConfigLists\RecipeConfigList.cs", "C#", 10, 0, 0, 1, 11
"d:\FileFolder\Life\Unity\Projects\PVZR\PVZ_Rouge\Assets\Scripts\Classes\ConfigLists\ZombieArmorDefinitionList.cs", "C#", 18, 0, 0, 2, 20
"d:\FileFolder\Life\Unity\Projects\PVZR\PVZ_Rouge\Assets\Scripts\Classes\DataClasses\Award\AwardData.cs", "C#", 27, 0, 0, 4, 31
"d:\FileFolder\Life\Unity\Projects\PVZR\PVZ_Rouge\Assets\Scripts\Classes\DataClasses\CoinTrade\CoinTradeData.cs", "C#", 24, 0, 0, 5, 29
"d:\FileFolder\Life\Unity\Projects\PVZR\PVZ_Rouge\Assets\Scripts\Classes\DataClasses\CoinTrade\CoinTradeGenerateInfo.cs", "C#", 16, 0, 0, 2, 18
"d:\FileFolder\Life\Unity\Projects\PVZR\PVZ_Rouge\Assets\Scripts\Classes\DataClasses\CoinTrade\CoinTradeInfo.cs", "C#", 11, 0, 0, 1, 12
"d:\FileFolder\Life\Unity\Projects\PVZR\PVZ_Rouge\Assets\Scripts\Classes\DataClasses\Game\GameData.cs", "C#", 55, 0, 1, 9, 65
"d:\FileFolder\Life\Unity\Projects\PVZR\PVZ_Rouge\Assets\Scripts\Classes\DataClasses\Game\GameDef.cs", "C#", 10, 0, 0, 1, 11
"d:\FileFolder\Life\Unity\Projects\PVZR\PVZ_Rouge\Assets\Scripts\Classes\DataClasses\Game\GameDefinition.cs", "C#", 14, 0, 0, 1, 15
"d:\FileFolder\Life\Unity\Projects\PVZR\PVZ_Rouge\Assets\Scripts\Classes\DataClasses\Game\GameId.cs", "C#", 8, 0, 0, 0, 8
"d:\FileFolder\Life\Unity\Projects\PVZR\PVZ_Rouge\Assets\Scripts\Classes\DataClasses\GlobalEntityData.cs", "C#", 40, 0, 0, 3, 43
"d:\FileFolder\Life\Unity\Projects\PVZR\PVZ_Rouge\Assets\Scripts\Classes\DataClasses\InventoryData.cs", "C#", 239, 0, 8, 58, 305
"d:\FileFolder\Life\Unity\Projects\PVZR\PVZ_Rouge\Assets\Scripts\Classes\DataClasses\Item\Card\CardData.cs", "C#", 29, 0, 0, 4, 33
"d:\FileFolder\Life\Unity\Projects\PVZR\PVZ_Rouge\Assets\Scripts\Classes\DataClasses\Item\Card\CardDefinition.cs", "C#", 16, 0, 2, 4, 22
"d:\FileFolder\Life\Unity\Projects\PVZR\PVZ_Rouge\Assets\Scripts\Classes\DataClasses\Item\Card\CardQuality.cs", "C#", 12, 0, 0, 0, 12
"d:\FileFolder\Life\Unity\Projects\PVZR\PVZ_Rouge\Assets\Scripts\Classes\DataClasses\Item\ItemData.cs", "C#", 8, 0, 0, 1, 9
"d:\FileFolder\Life\Unity\Projects\PVZR\PVZ_Rouge\Assets\Scripts\Classes\DataClasses\Item\ItemType.cs", "C#", 8, 0, 0, 0, 8
"d:\FileFolder\Life\Unity\Projects\PVZR\PVZ_Rouge\Assets\Scripts\Classes\DataClasses\Item\PlantBook\PlantBookData.cs", "C#", 31, 0, 1, 7, 39
"d:\FileFolder\Life\Unity\Projects\PVZR\PVZ_Rouge\Assets\Scripts\Classes\DataClasses\Item\PlantBook\PlantBookDefinition.cs", "C#", 14, 0, 0, 1, 15
"d:\FileFolder\Life\Unity\Projects\PVZR\PVZ_Rouge\Assets\Scripts\Classes\DataClasses\Item\PlantBook\PlantBookId.cs", "C#", 8, 0, 0, 0, 8
"d:\FileFolder\Life\Unity\Projects\PVZR\PVZ_Rouge\Assets\Scripts\Classes\DataClasses\Level\LevelData.cs", "C#", 200, 0, 6, 78, 284
"d:\FileFolder\Life\Unity\Projects\PVZR\PVZ_Rouge\Assets\Scripts\Classes\DataClasses\Level\LevelDef.cs", "C#", 62, 0, 1, 14, 77
"d:\FileFolder\Life\Unity\Projects\PVZR\PVZ_Rouge\Assets\Scripts\Classes\DataClasses\Level\LevelDefinition.cs", "C#", 117, 0, 5, 26, 148
"d:\FileFolder\Life\Unity\Projects\PVZR\PVZ_Rouge\Assets\Scripts\Classes\DataClasses\Level\LevelId.cs", "C#", 18, 0, 22, 2, 42
"d:\FileFolder\Life\Unity\Projects\PVZR\PVZ_Rouge\Assets\Scripts\Classes\DataClasses\Loot\LootData.cs", "C#", 42, 0, 3, 7, 52
"d:\FileFolder\Life\Unity\Projects\PVZR\PVZ_Rouge\Assets\Scripts\Classes\DataClasses\Loot\LootGenerateInfo.cs", "C#", 16, 0, 0, 2, 18
"d:\FileFolder\Life\Unity\Projects\PVZR\PVZ_Rouge\Assets\Scripts\Classes\DataClasses\Loot\LootInfo.cs", "C#", 15, 0, 3, 4, 22
"d:\FileFolder\Life\Unity\Projects\PVZR\PVZ_Rouge\Assets\Scripts\Classes\DataClasses\Loot\LootPool.cs", "C#", 71, 0, 0, 12, 83
"d:\FileFolder\Life\Unity\Projects\PVZR\PVZ_Rouge\Assets\Scripts\Classes\DataClasses\Loot\LootType.cs", "C#", 10, 0, 0, 0, 10
"d:\FileFolder\Life\Unity\Projects\PVZR\PVZ_Rouge\Assets\Scripts\Classes\DataClasses\Recipe\RecipeData.cs", "C#", 22, 0, 0, 2, 24
"d:\FileFolder\Life\Unity\Projects\PVZR\PVZ_Rouge\Assets\Scripts\Classes\DataClasses\Recipe\RecipeGenerateInfo.cs", "C#", 14, 0, 0, 1, 15
"d:\FileFolder\Life\Unity\Projects\PVZR\PVZ_Rouge\Assets\Scripts\Classes\DataClasses\Recipe\RecipeInfo.cs", "C#", 15, 0, 0, 1, 16
"d:\FileFolder\Life\Unity\Projects\PVZR\PVZ_Rouge\Assets\Scripts\Classes\DataClasses\Tomb\TombData.cs", "C#", 64, 0, 1, 10, 75
"d:\FileFolder\Life\Unity\Projects\PVZR\PVZ_Rouge\Assets\Scripts\Classes\DataClasses_InLevel\Attack\AttackData.cs", "C#", 110, 0, 1, 24, 135
"d:\FileFolder\Life\Unity\Projects\PVZR\PVZ_Rouge\Assets\Scripts\Classes\DataClasses_InLevel\Attack\AttackDefinition.cs", "C#", 23, 0, 0, 2, 25
"d:\FileFolder\Life\Unity\Projects\PVZR\PVZ_Rouge\Assets\Scripts\Classes\DataClasses_InLevel\Attack\AttackId.cs", "C#", 32, 0, 0, 1, 33
"d:\FileFolder\Life\Unity\Projects\PVZR\PVZ_Rouge\Assets\Scripts\Classes\DataClasses_InLevel\Cell\AllowedPlantingLocation.cs", "C#", 71, 0, 7, 14, 92
"d:\FileFolder\Life\Unity\Projects\PVZR\PVZ_Rouge\Assets\Scripts\Classes\DataClasses_InLevel\Cell\Cell.cs", "C#", 47, 0, 4, 9, 60
"d:\FileFolder\Life\Unity\Projects\PVZR\PVZ_Rouge\Assets\Scripts\Classes\DataClasses_InLevel\Cell\CellPlantData.cs", "C#", 109, 0, 0, 15, 124
"d:\FileFolder\Life\Unity\Projects\PVZR\PVZ_Rouge\Assets\Scripts\Classes\DataClasses_InLevel\Cell\PlacementSlot.cs", "C#", 10, 0, 3, 0, 13
"d:\FileFolder\Life\Unity\Projects\PVZR\PVZ_Rouge\Assets\Scripts\Classes\DataClasses_InLevel\Cell\TileState.cs", "C#", 14, 0, 0, 0, 14
"d:\FileFolder\Life\Unity\Projects\PVZR\PVZ_Rouge\Assets\Scripts\Classes\DataClasses_InLevel\Effect\EffectData.cs", "C#", 29, 0, 0, 6, 35
"d:\FileFolder\Life\Unity\Projects\PVZR\PVZ_Rouge\Assets\Scripts\Classes\DataClasses_InLevel\Effect\EffectDefinition.cs", "C#", 12, 0, 0, 1, 13
"d:\FileFolder\Life\Unity\Projects\PVZR\PVZ_Rouge\Assets\Scripts\Classes\DataClasses_InLevel\Effect\EffectGroup.cs", "C#", 87, 0, 5, 13, 105
"d:\FileFolder\Life\Unity\Projects\PVZR\PVZ_Rouge\Assets\Scripts\Classes\DataClasses_InLevel\Effect\EffectId.cs", "C#", 10, 0, 0, 0, 10
"d:\FileFolder\Life\Unity\Projects\PVZR\PVZ_Rouge\Assets\Scripts\Classes\DataClasses_InLevel\SeedData.cs", "C#", 22, 0, 2, 6, 30
"d:\FileFolder\Life\Unity\Projects\PVZR\PVZ_Rouge\Assets\Scripts\Classes\DataClasses_InLevel\ZombieArmor\ArmorState.cs", "C#", 10, 0, 0, 0, 10
"d:\FileFolder\Life\Unity\Projects\PVZR\PVZ_Rouge\Assets\Scripts\Classes\DataClasses_InLevel\ZombieArmor\ZombieArmorData.cs", "C#", 68, 0, 7, 17, 92
"d:\FileFolder\Life\Unity\Projects\PVZR\PVZ_Rouge\Assets\Scripts\Classes\DataClasses_InLevel\ZombieArmor\ZombieArmorDefinition.cs", "C#", 14, 0, 0, 2, 16
"d:\FileFolder\Life\Unity\Projects\PVZR\PVZ_Rouge\Assets\Scripts\Classes\DataClasses_InLevel\ZombieArmor\ZombieArmorId.cs", "C#", 11, 0, 0, 0, 11
"d:\FileFolder\Life\Unity\Projects\PVZR\PVZ_Rouge\Assets\Scripts\Classes\InfoClasses\PlantDef.cs", "C#", 39, 0, 0, 8, 47
"d:\FileFolder\Life\Unity\Projects\PVZR\PVZ_Rouge\Assets\Scripts\Classes\InfoClasses\PlantId.cs", "C#", 39, 0, 6, 3, 48
"d:\FileFolder\Life\Unity\Projects\PVZR\PVZ_Rouge\Assets\Scripts\Classes\InfoClasses\PlantVariant.cs", "C#", 18, 0, 0, 1, 19
"d:\FileFolder\Life\Unity\Projects\PVZR\PVZ_Rouge\Assets\Scripts\Classes\InfoClasses\ProjectileId.cs", "C#", 22, 0, 0, 1, 23
"d:\FileFolder\Life\Unity\Projects\PVZR\PVZ_Rouge\Assets\Scripts\Classes\InfoClasses\ZombieId.cs", "C#", 17, 0, 0, 1, 18
"d:\FileFolder\Life\Unity\Projects\PVZR\PVZ_Rouge\Assets\Scripts\Classes\LootPool\LootPoolInfo.cs", "C#", 37, 0, 0, 8, 45
"d:\FileFolder\Life\Unity\Projects\PVZR\PVZ_Rouge\Assets\Scripts\Classes\MazeMap\Controllers\DaveLawnController.cs", "C#", 292, 0, 46, 48, 386
"d:\FileFolder\Life\Unity\Projects\PVZR\PVZ_Rouge\Assets\Scripts\Classes\MazeMap\MazeMapController.cs", "C#", 189, 0, 11, 54, 254
"d:\FileFolder\Life\Unity\Projects\PVZR\PVZ_Rouge\Assets\Scripts\Classes\MazeMap\MazeMapData.cs", "C#", 133, 0, 6, 34, 173
"d:\FileFolder\Life\Unity\Projects\PVZR\PVZ_Rouge\Assets\Scripts\Classes\MazeMap\MazeMapDef.cs", "C#", 34, 0, 0, 7, 41
"d:\FileFolder\Life\Unity\Projects\PVZR\PVZ_Rouge\Assets\Scripts\Classes\MazeMap\MazeMapDefinition.cs", "C#", 53, 0, 2, 8, 63
"d:\FileFolder\Life\Unity\Projects\PVZR\PVZ_Rouge\Assets\Scripts\Classes\MazeMap\MazeMapId.cs", "C#", 9, 0, 0, 1, 10
"d:\FileFolder\Life\Unity\Projects\PVZR\PVZ_Rouge\Assets\Scripts\Classes\MazeMap\Node.cs", "C#", 48, 0, 3, 6, 57
"d:\FileFolder\Life\Unity\Projects\PVZR\PVZ_Rouge\Assets\Scripts\Classes\MazeMap\Workflow.md", "Markdown", 0, 0, 0, 1, 1
"d:\FileFolder\Life\Unity\Projects\PVZR\PVZ_Rouge\Assets\Scripts\Classes\ZombieAI\Class\Cluster.cs", "C#", 75, 0, 3, 14, 92
"d:\FileFolder\Life\Unity\Projects\PVZR\PVZ_Rouge\Assets\Scripts\Classes\ZombieAI\Class\Edge.cs", "C#", 23, 0, 0, 4, 27
"d:\FileFolder\Life\Unity\Projects\PVZR\PVZ_Rouge\Assets\Scripts\Classes\ZombieAI\Class\EdgeWeightCalculator.cs", "C#", 37, 0, 3, 8, 48
"d:\FileFolder\Life\Unity\Projects\PVZR\PVZ_Rouge\Assets\Scripts\Classes\ZombieAI\Class\FromToKey.cs", "C#", 26, 0, 0, 5, 31
"d:\FileFolder\Life\Unity\Projects\PVZR\PVZ_Rouge\Assets\Scripts\Classes\ZombieAI\Class\KeyEdge.cs", "C#", 85, 0, 10, 25, 120
"d:\FileFolder\Life\Unity\Projects\PVZR\PVZ_Rouge\Assets\Scripts\Classes\ZombieAI\Class\Path.cs", "C#", 48, 0, 21, 13, 82
"d:\FileFolder\Life\Unity\Projects\PVZR\PVZ_Rouge\Assets\Scripts\Classes\ZombieAI\Class\PathKey.cs", "C#", 27, 0, 0, 4, 31
"d:\FileFolder\Life\Unity\Projects\PVZR\PVZ_Rouge\Assets\Scripts\Classes\ZombieAI\Class\Vertex.cs", "C#", 76, 0, 7, 21, 104
"d:\FileFolder\Life\Unity\Projects\PVZR\PVZ_Rouge\Assets\Scripts\Classes\ZombieAI\PathFinding\AStarPathfinder.cs", "C#", 164, 0, 15, 38, 217
"d:\FileFolder\Life\Unity\Projects\PVZR\PVZ_Rouge\Assets\Scripts\Classes\ZombieAI\PathFinding\PathCache.cs", "C#", 46, 0, 0, 12, 58
"d:\FileFolder\Life\Unity\Projects\PVZR\PVZ_Rouge\Assets\Scripts\Classes\ZombieAI\PathFinding\PathFindingAlgorithm.cs", "C#", 51, 0, 7, 7, 65
"d:\FileFolder\Life\Unity\Projects\PVZR\PVZ_Rouge\Assets\Scripts\Classes\ZombieAI\PathFinding\PathManager.cs", "C#", 106, 0, 16, 33, 155
"d:\FileFolder\Life\Unity\Projects\PVZR\PVZ_Rouge\Assets\Scripts\Classes\ZombieAI\PathFinding\ZombieAIUnit.cs", "C#", 519, 0, 131, 104, 754
"d:\FileFolder\Life\Unity\Projects\PVZR\PVZ_Rouge\Assets\Scripts\Classes\ZombieAI\Public\AITendency.cs", "C#", 87, 0, 27, 22, 136
"d:\FileFolder\Life\Unity\Projects\PVZR\PVZ_Rouge\Assets\Scripts\Classes\ZombieAI\Public\IZombieAIUnit.cs", "C#", 17, 0, 3, 1, 21
"d:\FileFolder\Life\Unity\Projects\PVZR\PVZ_Rouge\Assets\Scripts\Classes\ZombieAI\Public\IZombiePath.cs", "C#", 42, 0, 0, 12, 54
"d:\FileFolder\Life\Unity\Projects\PVZR\PVZ_Rouge\Assets\Scripts\Classes\ZombieAI\Public\MoveData.cs", "C#", 39, 0, 0, 8, 47
"d:\FileFolder\Life\Unity\Projects\PVZR\PVZ_Rouge\Assets\Scripts\Classes\ZombieAI\Public\MoveType.cs", "C#", 20, 0, 0, 1, 21
"d:\FileFolder\Life\Unity\Projects\PVZR\PVZ_Rouge\Assets\Scripts\Classes\ZombieSpawner\ZombieSpawnInfo.cs", "C#", 21, 0, 0, 2, 23
"d:\FileFolder\Life\Unity\Projects\PVZR\PVZ_Rouge\Assets\Scripts\Classes\ZombieSpawner\ZombieSpawnTask.cs", "C#", 70, 0, 5, 16, 91
"d:\FileFolder\Life\Unity\Projects\PVZR\PVZ_Rouge\Assets\Scripts\CommandEvents\Game_Main\OnCollectLevelEndObjectCommand.cs", "C#", 15, 0, 2, 3, 20
"d:\FileFolder\Life\Unity\Projects\PVZR\PVZ_Rouge\Assets\Scripts\CommandEvents\Game_Main\StartGameCommand.cs", "C#", 26, 0, 1, 5, 32
"d:\FileFolder\Life\Unity\Projects\PVZR\PVZ_Rouge\Assets\Scripts\CommandEvents\Game_Main\StartLevelCommands.cs", "C#", 25, 0, 2, 6, 33
"d:\FileFolder\Life\Unity\Projects\PVZR\PVZ_Rouge\Assets\Scripts\CommandEvents\Game_Main\StartNewGameCommand.cs", "C#", 25, 0, 3, 4, 32
"d:\FileFolder\Life\Unity\Projects\PVZR\PVZ_Rouge\Assets\Scripts\CommandEvents\Level_ChooseSeeds\ChooseSeedCommand.cs", "C#", 58, 0, 7, 8, 73
"d:\FileFolder\Life\Unity\Projects\PVZR\PVZ_Rouge\Assets\Scripts\CommandEvents\Level_ChooseSeeds\OnStartGameBtnPressedCommand.cs", "C#", 15, 0, 2, 2, 19
"d:\FileFolder\Life\Unity\Projects\PVZR\PVZ_Rouge\Assets\Scripts\CommandEvents\Level_ChooseSeeds\UnchooseSeedCommand.cs", "C#", 55, 0, 7, 8, 70
"d:\FileFolder\Life\Unity\Projects\PVZR\PVZ_Rouge\Assets\Scripts\CommandEvents\Level_Collectables\Coins\CollectCoinCommand.cs", "C#", 33, 0, 0, 6, 39
"d:\FileFolder\Life\Unity\Projects\PVZR\PVZ_Rouge\Assets\Scripts\CommandEvents\Level_Collectables\Coins\SpawnCoinFromPlantCommand.cs", "C#", 27, 0, 0, 4, 31
"d:\FileFolder\Life\Unity\Projects\PVZR\PVZ_Rouge\Assets\Scripts\CommandEvents\Level_Collectables\CollectSunCommand.cs", "C#", 25, 0, 0, 5, 30
"d:\FileFolder\Life\Unity\Projects\PVZR\PVZ_Rouge\Assets\Scripts\CommandEvents\Level_Collectables\SpawnSunFromPlantCommand.cs", "C#", 29, 0, 0, 4, 33
"d:\FileFolder\Life\Unity\Projects\PVZR\PVZ_Rouge\Assets\Scripts\CommandEvents\Level_Hand\DeselectCommand.cs", "C#", 27, 0, 2, 4, 33
"d:\FileFolder\Life\Unity\Projects\PVZR\PVZ_Rouge\Assets\Scripts\CommandEvents\Level_Hand\OnSeedInHandPlanted.cs", "C#", 10, 0, 0, 1, 11
"d:\FileFolder\Life\Unity\Projects\PVZR\PVZ_Rouge\Assets\Scripts\CommandEvents\Level_Hand\OnShovelUsed.cs", "C#", 6, 0, 0, 0, 6
"d:\FileFolder\Life\Unity\Projects\PVZR\PVZ_Rouge\Assets\Scripts\CommandEvents\Level_Hand\PlantingSeedInHandCommand.cs", "C#", 54, 0, 1, 7, 62
"d:\FileFolder\Life\Unity\Projects\PVZR\PVZ_Rouge\Assets\Scripts\CommandEvents\Level_Hand\SelectSeedCommand.cs", "C#", 38, 0, 2, 5, 45
"d:\FileFolder\Life\Unity\Projects\PVZR\PVZ_Rouge\Assets\Scripts\CommandEvents\Level_Hand\SelectShovelCommand.cs", "C#", 27, 0, 2, 4, 33
"d:\FileFolder\Life\Unity\Projects\PVZR\PVZ_Rouge\Assets\Scripts\CommandEvents\Level_Hand\UseShovelCommand.cs", "C#", 41, 0, 2, 4, 47
"d:\FileFolder\Life\Unity\Projects\PVZR\PVZ_Rouge\Assets\Scripts\CommandEvents\Level_Plant\OnPlantRemoved.cs", "C#", 9, 0, 0, 1, 10
"d:\FileFolder\Life\Unity\Projects\PVZR\PVZ_Rouge\Assets\Scripts\CommandEvents\Level_Plant\OnPlantSpawned.cs", "C#", 10, 0, 0, 1, 11
"d:\FileFolder\Life\Unity\Projects\PVZR\PVZ_Rouge\Assets\Scripts\CommandEvents\Level_Plant\RemovePlantCommand.cs", "C#", 35, 0, 2, 6, 43
"d:\FileFolder\Life\Unity\Projects\PVZR\PVZ_Rouge\Assets\Scripts\CommandEvents\Level_Plant\SpawnPlantCommand.cs", "C#", 44, 0, 3, 6, 53
"d:\FileFolder\Life\Unity\Projects\PVZR\PVZ_Rouge\Assets\Scripts\CommandEvents\Level_Shit\OnWaveStart.cs", "C#", 7, 0, 0, 0, 7
"d:\FileFolder\Life\Unity\Projects\PVZR\PVZ_Rouge\Assets\Scripts\CommandEvents\Level_Shit\ShitEvents.cs", "C#", 9, 0, 0, 1, 10
"d:\FileFolder\Life\Unity\Projects\PVZR\PVZ_Rouge\Assets\Scripts\CommandEvents\Level_Zombie\OnZombieDeathCommand.cs", "C#", 37, 0, 5, 7, 49
"d:\FileFolder\Life\Unity\Projects\PVZR\PVZ_Rouge\Assets\Scripts\CommandEvents\Main_Phase\PhaseEvents.cs", "C#", 20, 0, 0, 2, 22
"d:\FileFolder\Life\Unity\Projects\PVZR\PVZ_Rouge\Assets\Scripts\CommandEvents\MazeMap_Main\EndCurrentGameCommand.cs", "C#", 18, 0, 2, 2, 22
"d:\FileFolder\Life\Unity\Projects\PVZR\PVZ_Rouge\Assets\Scripts\CommandEvents\MazeMap_UIPanels\MazeMap_AwardPanel\ChooseAwardCommand.cs", "C#", 26, 0, 0, 6, 32
"d:\FileFolder\Life\Unity\Projects\PVZR\PVZ_Rouge\Assets\Scripts\CommandEvents\MazeMap_UIPanels\MazeMap_StorePanel\BarterCommand.cs", "C#", 30, 0, 2, 8, 40
"d:\FileFolder\Life\Unity\Projects\PVZR\PVZ_Rouge\Assets\Scripts\CommandEvents\MazeMap_UIPanels\MazeMap_StorePanel\CoinStoreRefreshCommand.cs", "C#", 23, 0, 2, 4, 29
"d:\FileFolder\Life\Unity\Projects\PVZR\PVZ_Rouge\Assets\Scripts\CommandEvents\MazeMap_UIPanels\MazeMap_StorePanel\CoinTradeCommand.cs", "C#", 32, 0, 2, 8, 42
"d:\FileFolder\Life\Unity\Projects\PVZR\PVZ_Rouge\Assets\Scripts\CommandEvents\MazeMap_UIPanels\MazeMap_StorePanel\SellTradeCommand.cs", "C#", 32, 0, 2, 6, 40
"d:\FileFolder\Life\Unity\Projects\PVZR\PVZ_Rouge\Assets\Scripts\CommandEvents\MazeMap_UIPanels\OpenLevelPreviewPanelCommand.cs", "C#", 29, 0, 2, 6, 37
"d:\FileFolder\Life\Unity\Projects\PVZR\PVZ_Rouge\Assets\Scripts\Docs\SortingLayer.md", "Markdown", 0, 45, 0, 9, 54
"d:\FileFolder\Life\Unity\Projects\PVZR\PVZ_Rouge\Assets\Scripts\Docs\Untitled.md", "Markdown", 0, 4, 0, 1, 5
"d:\FileFolder\Life\Unity\Projects\PVZR\PVZ_Rouge\Assets\Scripts\Docs\待办事项.md", "Markdown", 0, 83, 0, 10, 93
"d:\FileFolder\Life\Unity\Projects\PVZR\PVZ_Rouge\Assets\Scripts\Docs\我希望自己记住的东西.md", "Markdown", 0, 15, 0, 16, 31
"d:\FileFolder\Life\Unity\Projects\PVZR\PVZ_Rouge\Assets\Scripts\Docs\抽卡理论.md", "Markdown", 0, 23, 0, 18, 41
"d:\FileFolder\Life\Unity\Projects\PVZR\PVZ_Rouge\Assets\Scripts\Docs\目前相对于原版做的创新.md", "Markdown", 0, 11, 0, 3, 14
"d:\FileFolder\Life\Unity\Projects\PVZR\PVZ_Rouge\Assets\Scripts\Helpers\ClassCreator\AttackCreator.cs", "C#", 13, 0, 0, 1, 14
"d:\FileFolder\Life\Unity\Projects\PVZR\PVZ_Rouge\Assets\Scripts\Helpers\ClassCreator\AwardCreator.cs", "C#", 35, 0, 2, 4, 41
"d:\FileFolder\Life\Unity\Projects\PVZR\PVZ_Rouge\Assets\Scripts\Helpers\ClassCreator\GameCreator.cs", "C#", 45, 0, 3, 6, 54
"d:\FileFolder\Life\Unity\Projects\PVZR\PVZ_Rouge\Assets\Scripts\Helpers\ClassCreator\ItemCreator.cs", "C#", 20, 0, 0, 2, 22
"d:\FileFolder\Life\Unity\Projects\PVZR\PVZ_Rouge\Assets\Scripts\Helpers\ClassCreator\LootCreator.cs", "C#", 109, 0, 28, 15, 152
"d:\FileFolder\Life\Unity\Projects\PVZR\PVZ_Rouge\Assets\Scripts\Helpers\ClassCreator\TombCreator.cs", "C#", 14, 0, 0, 1, 15
"d:\FileFolder\Life\Unity\Projects\PVZR\PVZ_Rouge\Assets\Scripts\Helpers\ClassCreator\TradeCreator.cs", "C#", 136, 0, 0, 23, 159
"d:\FileFolder\Life\Unity\Projects\PVZR\PVZ_Rouge\Assets\Scripts\Helpers\ClassCreator\ZombieArmorCreator.cs", "C#", 13, 0, 0, 1, 14
"d:\FileFolder\Life\Unity\Projects\PVZR\PVZ_Rouge\Assets\Scripts\Helpers\ConfigReader\AttackConfigReader.cs", "C#", 38, 0, 0, 9, 47
"d:\FileFolder\Life\Unity\Projects\PVZR\PVZ_Rouge\Assets\Scripts\Helpers\ConfigReader\EconomyConfigReader.cs", "C#", 128, 0, 10, 30, 168
"d:\FileFolder\Life\Unity\Projects\PVZR\PVZ_Rouge\Assets\Scripts\Helpers\ConfigReader\GameConfigReader.cs", "C#", 74, 0, 3, 16, 93
"d:\FileFolder\Life\Unity\Projects\PVZR\PVZ_Rouge\Assets\Scripts\Helpers\ConfigReader\LootPoolConfigReader.cs", "C#", 91, 0, 8, 15, 114
"d:\FileFolder\Life\Unity\Projects\PVZR\PVZ_Rouge\Assets\Scripts\Helpers\ConfigReader\PlantBookConfigReader.cs", "C#", 40, 0, 0, 10, 50
"d:\FileFolder\Life\Unity\Projects\PVZR\PVZ_Rouge\Assets\Scripts\Helpers\ConfigReader\PlantConfigReader.cs", "C#", 111, 0, 1, 21, 133
"d:\FileFolder\Life\Unity\Projects\PVZR\PVZ_Rouge\Assets\Scripts\Helpers\ConfigReader\RecipeConfigReader.cs", "C#", 87, 0, 10, 15, 112
"d:\FileFolder\Life\Unity\Projects\PVZR\PVZ_Rouge\Assets\Scripts\Helpers\ConfigReader\ZombieArmorConfigReader.cs", "C#", 39, 0, 1, 9, 49
"d:\FileFolder\Life\Unity\Projects\PVZR\PVZ_Rouge\Assets\Scripts\Helpers\GameObjectFactory\EntityFactory.cs", "C#", 221, 0, 3, 45, 269
"d:\FileFolder\Life\Unity\Projects\PVZR\PVZ_Rouge\Assets\Scripts\Helpers\GameObjectFactory\ItemViewFactory.cs", "C#", 68, 0, 0, 10, 78
"d:\FileFolder\Life\Unity\Projects\PVZR\PVZ_Rouge\Assets\Scripts\Helpers\GameObjectFactory\ShitFactory.cs", "C#", 43, 0, 0, 7, 50
"d:\FileFolder\Life\Unity\Projects\PVZR\PVZ_Rouge\Assets\Scripts\Helpers\Methods\EffectHelper.cs", "C#", 15, 0, 0, 1, 16
"d:\FileFolder\Life\Unity\Projects\PVZR\PVZ_Rouge\Assets\Scripts\Helpers\Methods\Global.cs", "C#", 11, 0, 0, 1, 12
"d:\FileFolder\Life\Unity\Projects\PVZR\PVZ_Rouge\Assets\Scripts\Helpers\Methods\HandHelper.cs", "C#", 34, 0, 1, 10, 45
"d:\FileFolder\Life\Unity\Projects\PVZR\PVZ_Rouge\Assets\Scripts\Helpers\Methods\LevelGridHelper.cs", "C#", 28, 0, 1, 4, 33
"d:\FileFolder\Life\Unity\Projects\PVZR\PVZ_Rouge\Assets\Scripts\Helpers\Methods\LevelMatrixHelper.cs", "C#", 59, 0, 1, 5, 65
"d:\FileFolder\Life\Unity\Projects\PVZR\PVZ_Rouge\Assets\Scripts\Helpers\NoticeHelper.cs", "C#", 8, 0, 3, 1, 12
"d:\FileFolder\Life\Unity\Projects\PVZR\PVZ_Rouge\Assets\Scripts\Helpers\PlantDefHelper.cs", "C#", 38, 0, 0, 4, 42
"d:\FileFolder\Life\Unity\Projects\PVZR\PVZ_Rouge\Assets\Scripts\Helpers\SeedHelper.cs", "C#", 24, 0, 6, 6, 36
"d:\FileFolder\Life\Unity\Projects\PVZR\PVZ_Rouge\Assets\Scripts\Models\GameModel.cs", "C#", 25, 0, 3, 6, 34
"d:\FileFolder\Life\Unity\Projects\PVZR\PVZ_Rouge\Assets\Scripts\Models\GamePhase.cs", "C#", 57, 0, 7, 11, 75
"d:\FileFolder\Life\Unity\Projects\PVZR\PVZ_Rouge\Assets\Scripts\Models\LevelGridModel.cs", "C#", 93, 0, 8, 19, 120
"d:\FileFolder\Life\Unity\Projects\PVZR\PVZ_Rouge\Assets\Scripts\Models\LevelModel.cs", "C#", 56, 0, 3, 14, 73
"d:\FileFolder\Life\Unity\Projects\PVZR\PVZ_Rouge\Assets\Scripts\Models\PhaseModel.cs", "C#", 98, 0, 16, 21, 135
"d:\FileFolder\Life\Unity\Projects\PVZR\PVZ_Rouge\Assets\Scripts\PVZRouge.cs", "C#", 38, 0, 3, 2, 43
"d:\FileFolder\Life\Unity\Projects\PVZR\PVZ_Rouge\Assets\Scripts\Systems\GameSystem.cs", "C#", 62, 0, 3, 6, 71
"d:\FileFolder\Life\Unity\Projects\PVZR\PVZ_Rouge\Assets\Scripts\Systems\InventorySystem.cs", "C#", 47, 0, 0, 7, 54
"d:\FileFolder\Life\Unity\Projects\PVZR\PVZ_Rouge\Assets\Scripts\Systems\Level_Data\HandSystem.cs", "C#", 66, 0, 4, 17, 87
"d:\FileFolder\Life\Unity\Projects\PVZR\PVZ_Rouge\Assets\Scripts\Systems\Level_Data\LevelGridSystem.cs", "C#", 30, 0, 0, 5, 35
"d:\FileFolder\Life\Unity\Projects\PVZR\PVZ_Rouge\Assets\Scripts\Systems\Level_Data\LevelSystem.cs", "C#", 170, 0, 10, 19, 199
"d:\FileFolder\Life\Unity\Projects\PVZR\PVZ_Rouge\Assets\Scripts\Systems\Level_Data\PlantServiceSystem.cs", "C#", 27, 0, 0, 4, 31
"d:\FileFolder\Life\Unity\Projects\PVZR\PVZ_Rouge\Assets\Scripts\Systems\Level_Data\SeedSystem.cs", "C#", 54, 0, 3, 10, 67
"d:\FileFolder\Life\Unity\Projects\PVZR\PVZ_Rouge\Assets\Scripts\Systems\Level_Data\SunSystem.cs", "C#", 21, 0, 0, 4, 25
"d:\FileFolder\Life\Unity\Projects\PVZR\PVZ_Rouge\Assets\Scripts\Systems\Level_Data\ZombieAISystem.cs", "C#", 97, 0, 8, 16, 121
"d:\FileFolder\Life\Unity\Projects\PVZR\PVZ_Rouge\Assets\Scripts\Systems\Level_Event\EnvironmentSystem.cs", "C#", 62, 0, 0, 14, 76
"d:\FileFolder\Life\Unity\Projects\PVZR\PVZ_Rouge\Assets\Scripts\Systems\Level_Event\WaveSystem.cs", "C#", 61, 0, 0, 12, 73
"d:\FileFolder\Life\Unity\Projects\PVZR\PVZ_Rouge\Assets\Scripts\Systems\Level_Event\ZombieSpawnSystem.cs", "C#", 90, 0, 0, 14, 104
"d:\FileFolder\Life\Unity\Projects\PVZR\PVZ_Rouge\Assets\Scripts\Systems\MainGameSystem.cs", "C#", 53, 0, 1, 6, 60
"d:\FileFolder\Life\Unity\Projects\PVZR\PVZ_Rouge\Assets\Scripts\Systems\MazeMap\AwardSystem.cs", "C#", 98, 0, 0, 17, 115
"d:\FileFolder\Life\Unity\Projects\PVZR\PVZ_Rouge\Assets\Scripts\Systems\MazeMap\CoinStoreSystem.cs", "C#", 103, 0, 3, 22, 128
"d:\FileFolder\Life\Unity\Projects\PVZR\PVZ_Rouge\Assets\Scripts\Systems\MazeMap\MazeMapSystem.cs", "C#", 115, 0, 8, 17, 140
"d:\FileFolder\Life\Unity\Projects\PVZR\PVZ_Rouge\Assets\Scripts\Systems\MazeMap\RecipeStoreSystem.cs", "C#", 107, 0, 2, 18, 127
"d:\FileFolder\Life\Unity\Projects\PVZR\PVZ_Rouge\Assets\Scripts\Systems\MazeMap\SellStoreSystem.cs", "C#", 98, 0, 3, 20, 121
"d:\FileFolder\Life\Unity\Projects\PVZR\PVZ_Rouge\Assets\Scripts\Systems\SaveSystem.cs", "C#", 50, 0, 0, 7, 57
"d:\FileFolder\Life\Unity\Projects\PVZR\PVZ_Rouge\Assets\Scripts\Tools\Attributes.cs", "C#", 10, 0, 0, 1, 11
"d:\FileFolder\Life\Unity\Projects\PVZR\PVZ_Rouge\Assets\Scripts\Tools\Enums.cs", "C#", 24, 0, 0, 4, 28
"d:\FileFolder\Life\Unity\Projects\PVZR\PVZ_Rouge\Assets\Scripts\Tools\Extensions.cs", "C#", 116, 0, 37, 18, 171
"d:\FileFolder\Life\Unity\Projects\PVZR\PVZ_Rouge\Assets\Scripts\Tools\Matrix.cs", "C#", 167, 0, 76, 42, 285
"d:\FileFolder\Life\Unity\Projects\PVZR\PVZ_Rouge\Assets\Scripts\Tools\PriorityQueue\FastPriorityQueue.cs", "C#", 438, 0, 106, 48, 592
"d:\FileFolder\Life\Unity\Projects\PVZR\PVZ_Rouge\Assets\Scripts\Tools\PriorityQueue\FastPriorityQueueNode.cs", "C#", 11, 0, 10, 3, 24
"d:\FileFolder\Life\Unity\Projects\PVZR\PVZ_Rouge\Assets\Scripts\Tools\PriorityQueue\IFixedSizePriorityQueue.cs", "C#", 9, 0, 15, 3, 27
"d:\FileFolder\Life\Unity\Projects\PVZR\PVZ_Rouge\Assets\Scripts\Tools\PriorityQueue\IPriorityQueue.cs", "C#", 15, 0, 30, 9, 54
"d:\FileFolder\Life\Unity\Projects\PVZR\PVZ_Rouge\Assets\Scripts\Tools\RandomPool.cs", "C#", 163, 0, 17, 40, 220
"d:\FileFolder\Life\Unity\Projects\PVZR\PVZ_Rouge\Assets\Scripts\Tools\Random\DeterministicRandom.cs", "C#", 160, 0, 74, 41, 275
"d:\FileFolder\Life\Unity\Projects\PVZR\PVZ_Rouge\Assets\Scripts\Tools\Random\RandomHelper.cs", "C#", 14, 0, 0, 4, 18
"d:\FileFolder\Life\Unity\Projects\PVZR\PVZ_Rouge\Assets\Scripts\Tools\Save\AwardSaveData.cs", "C#", 3, 0, 0, 0, 3
"d:\FileFolder\Life\Unity\Projects\PVZR\PVZ_Rouge\Assets\Scripts\Tools\Save\GameDataSave.cs", "C#", 69, 0, 0, 10, 79
"d:\FileFolder\Life\Unity\Projects\PVZR\PVZ_Rouge\Assets\Scripts\Tools\Save\ISavable.cs", "C#", 10, 0, 0, 2, 12
"d:\FileFolder\Life\Unity\Projects\PVZR\PVZ_Rouge\Assets\Scripts\Tools\Save\SaveHelper.cs", "C#", 87, 0, 20, 15, 122
"d:\FileFolder\Life\Unity\Projects\PVZR\PVZ_Rouge\Assets\Scripts\Tools\SoyoFramework\Core.cs", "C#", 22, 0, 15, 6, 43
"d:\FileFolder\Life\Unity\Projects\PVZR\PVZ_Rouge\Assets\Scripts\Tools\Timer.cs", "C#", 74, 0, 2, 14, 90
"d:\FileFolder\Life\Unity\Projects\PVZR\PVZ_Rouge\Assets\Scripts\Tools\TriggerDetector.cs", "C#", 48, 0, 2, 14, 64
"d:\FileFolder\Life\Unity\Projects\PVZR\PVZ_Rouge\Assets\Scripts\ViewControllers\Entities\EntityBase\Entity.cs", "C#", 57, 0, 10, 20, 87
"d:\FileFolder\Life\Unity\Projects\PVZR\PVZ_Rouge\Assets\Scripts\ViewControllers\Entities\EntityBase\Interfaces\IAttackable.cs", "C#", 14, 0, 10, 3, 27
"d:\FileFolder\Life\Unity\Projects\PVZR\PVZ_Rouge\Assets\Scripts\ViewControllers\Entities\EntityBase\Interfaces\IEffectable.cs", "C#", 8, 0, 0, 1, 9
"d:\FileFolder\Life\Unity\Projects\PVZR\PVZ_Rouge\Assets\Scripts\ViewControllers\Entities\EntityBase\Interfaces\IEntity.cs", "C#", 10, 0, 0, 1, 11
"d:\FileFolder\Life\Unity\Projects\PVZR\PVZ_Rouge\Assets\Scripts\ViewControllers\Entities\Plants\Base\IPlant.cs", "C#", 19, 0, 0, 3, 22
"d:\FileFolder\Life\Unity\Projects\PVZR\PVZ_Rouge\Assets\Scripts\ViewControllers\Entities\Plants\Base\Plant.cs", "C#", 79, 0, 3, 24, 106
"d:\FileFolder\Life\Unity\Projects\PVZR\PVZ_Rouge\Assets\Scripts\ViewControllers\Entities\Plants\Dave\BonkChoy.cs", "C#", 42, 0, 0, 8, 50
"d:\FileFolder\Life\Unity\Projects\PVZR\PVZ_Rouge\Assets\Scripts\ViewControllers\Entities\Plants\Dave\Cactus.cs", "C#", 42, 0, 0, 8, 50
"d:\FileFolder\Life\Unity\Projects\PVZR\PVZ_Rouge\Assets\Scripts\ViewControllers\Entities\Plants\Dave\PotatoMine.cs", "C#", 57, 0, 0, 10, 67
"d:\FileFolder\Life\Unity\Projects\PVZR\PVZ_Rouge\Assets\Scripts\ViewControllers\Entities\Plants\Dave\Starfruit.cs", "C#", 57, 0, 0, 8, 65
"d:\FileFolder\Life\Unity\Projects\PVZR\PVZ_Rouge\Assets\Scripts\ViewControllers\Entities\Plants\Dave\Tallnut.cs", "C#", 15, 0, 0, 2, 17
"d:\FileFolder\Life\Unity\Projects\PVZR\PVZ_Rouge\Assets\Scripts\ViewControllers\Entities\Plants\General\CherryBomb.cs", "C#", 37, 0, 0, 5, 42
"d:\FileFolder\Life\Unity\Projects\PVZR\PVZ_Rouge\Assets\Scripts\ViewControllers\Entities\Plants\General\Flowerpot.cs", "C#", 36, 0, 0, 3, 39
"d:\FileFolder\Life\Unity\Projects\PVZR\PVZ_Rouge\Assets\Scripts\ViewControllers\Entities\Plants\General\GoldBloom.cs", "C#", 54, 0, 0, 4, 58
"d:\FileFolder\Life\Unity\Projects\PVZR\PVZ_Rouge\Assets\Scripts\ViewControllers\Entities\Plants\General\IcebergLettuce.cs", "C#", 49, 0, 0, 8, 57
"d:\FileFolder\Life\Unity\Projects\PVZR\PVZ_Rouge\Assets\Scripts\ViewControllers\Entities\Plants\General\Jalapeno.cs", "C#", 38, 0, 0, 8, 46
"d:\FileFolder\Life\Unity\Projects\PVZR\PVZ_Rouge\Assets\Scripts\ViewControllers\Entities\Plants\General\LilyPad.cs", "C#", 36, 0, 0, 3, 39
"d:\FileFolder\Life\Unity\Projects\PVZR\PVZ_Rouge\Assets\Scripts\ViewControllers\Entities\Plants\General\Marigold.cs", "C#", 36, 0, 0, 8, 44
"d:\FileFolder\Life\Unity\Projects\PVZR\PVZ_Rouge\Assets\Scripts\ViewControllers\Entities\Plants\General\Pumpkin.cs", "C#", 23, 0, 0, 3, 26
"d:\FileFolder\Life\Unity\Projects\PVZR\PVZ_Rouge\Assets\Scripts\ViewControllers\Entities\Plants\General\Squash.cs", "C#", 65, 0, 0, 12, 77
"d:\FileFolder\Life\Unity\Projects\PVZR\PVZ_Rouge\Assets\Scripts\ViewControllers\Entities\Plants\General\Sunflower.cs", "C#", 33, 0, 0, 7, 40
"d:\FileFolder\Life\Unity\Projects\PVZR\PVZ_Rouge\Assets\Scripts\ViewControllers\Entities\Plants\General\TripletSunflower.cs", "C#", 35, 0, 0, 7, 42
"d:\FileFolder\Life\Unity\Projects\PVZR\PVZ_Rouge\Assets\Scripts\ViewControllers\Entities\Plants\General\TwinSunflower.cs", "C#", 34, 0, 0, 7, 41
"d:\FileFolder\Life\Unity\Projects\PVZR\PVZ_Rouge\Assets\Scripts\ViewControllers\Entities\Plants\General\Wallnut.cs", "C#", 15, 0, 0, 2, 17
"d:\FileFolder\Life\Unity\Projects\PVZR\PVZ_Rouge\Assets\Scripts\ViewControllers\Entities\Plants\PeaFamily\GatlingPea.cs", "C#", 53, 0, 0, 8, 61
"d:\FileFolder\Life\Unity\Projects\PVZR\PVZ_Rouge\Assets\Scripts\ViewControllers\Entities\Plants\PeaFamily\MungBeanShooter.cs", "C#", 46, 0, 1, 9, 56
"d:\FileFolder\Life\Unity\Projects\PVZR\PVZ_Rouge\Assets\Scripts\ViewControllers\Entities\Plants\PeaFamily\PeaPod.cs", "C#", 63, 0, 0, 14, 77
"d:\FileFolder\Life\Unity\Projects\PVZR\PVZ_Rouge\Assets\Scripts\ViewControllers\Entities\Plants\PeaFamily\Peashooter.cs", "C#", 43, 0, 0, 8, 51
"d:\FileFolder\Life\Unity\Projects\PVZR\PVZ_Rouge\Assets\Scripts\ViewControllers\Entities\Plants\PeaFamily\Repeater.cs", "C#", 52, 0, 0, 9, 61
"d:\FileFolder\Life\Unity\Projects\PVZR\PVZ_Rouge\Assets\Scripts\ViewControllers\Entities\Plants\PeaFamily\SniperPea.cs", "C#", 83, 0, 1, 11, 95
"d:\FileFolder\Life\Unity\Projects\PVZR\PVZ_Rouge\Assets\Scripts\ViewControllers\Entities\Plants\PeaFamily\SnowPea.cs", "C#", 42, 0, 0, 9, 51
"d:\FileFolder\Life\Unity\Projects\PVZR\PVZ_Rouge\Assets\Scripts\ViewControllers\Entities\Plants\PeaFamily\SplitPea.cs", "C#", 62, 0, 0, 12, 74
"d:\FileFolder\Life\Unity\Projects\PVZR\PVZ_Rouge\Assets\Scripts\ViewControllers\Entities\Plants\PeaFamily\Threepeater.cs", "C#", 66, 0, 0, 12, 78
"d:\FileFolder\Life\Unity\Projects\PVZR\PVZ_Rouge\Assets\Scripts\ViewControllers\Entities\Plants\PeaFamily\Torchwood.cs", "C#", 31, 0, 0, 6, 37
"d:\FileFolder\Life\Unity\Projects\PVZR\PVZ_Rouge\Assets\Scripts\ViewControllers\Entities\Plants\PultFamily\CabbagePult.cs", "C#", 48, 0, 0, 10, 58
"d:\FileFolder\Life\Unity\Projects\PVZR\PVZ_Rouge\Assets\Scripts\ViewControllers\Entities\Plants\PultFamily\KernelPult.cs", "C#", 76, 0, 0, 14, 90
"d:\FileFolder\Life\Unity\Projects\PVZR\PVZ_Rouge\Assets\Scripts\ViewControllers\Entities\Plants\PultFamily\MelonPult.cs", "C#", 48, 0, 0, 10, 58
"d:\FileFolder\Life\Unity\Projects\PVZR\PVZ_Rouge\Assets\Scripts\ViewControllers\Entities\Projectiles\Base\ICanBeIgnited.cs", "C#", 12, 0, 0, 1, 13
"d:\FileFolder\Life\Unity\Projects\PVZR\PVZ_Rouge\Assets\Scripts\ViewControllers\Entities\Projectiles\Base\IPeaLikeInit.cs", "C#", 9, 0, 0, 1, 10
"d:\FileFolder\Life\Unity\Projects\PVZR\PVZ_Rouge\Assets\Scripts\ViewControllers\Entities\Projectiles\Base\IProjectile.cs", "C#", 7, 0, 0, 1, 8
"d:\FileFolder\Life\Unity\Projects\PVZR\PVZ_Rouge\Assets\Scripts\ViewControllers\Entities\Projectiles\Base\Projectile.cs", "C#", 14, 0, 0, 4, 18
"d:\FileFolder\Life\Unity\Projects\PVZR\PVZ_Rouge\Assets\Scripts\ViewControllers\Entities\Projectiles\Butter.cs", "C#", 31, 0, 0, 6, 37
"d:\FileFolder\Life\Unity\Projects\PVZR\PVZ_Rouge\Assets\Scripts\ViewControllers\Entities\Projectiles\Cabbage.cs", "C#", 32, 0, 0, 6, 38
"d:\FileFolder\Life\Unity\Projects\PVZR\PVZ_Rouge\Assets\Scripts\ViewControllers\Entities\Projectiles\FirePea.cs", "C#", 40, 0, 0, 6, 46
"d:\FileFolder\Life\Unity\Projects\PVZR\PVZ_Rouge\Assets\Scripts\ViewControllers\Entities\Projectiles\FrozenPea.cs", "C#", 32, 0, 0, 6, 38
"d:\FileFolder\Life\Unity\Projects\PVZR\PVZ_Rouge\Assets\Scripts\ViewControllers\Entities\Projectiles\Kernel.cs", "C#", 32, 0, 0, 6, 38
"d:\FileFolder\Life\Unity\Projects\PVZR\PVZ_Rouge\Assets\Scripts\ViewControllers\Entities\Projectiles\Melon.cs", "C#", 41, 0, 0, 7, 48
"d:\FileFolder\Life\Unity\Projects\PVZR\PVZ_Rouge\Assets\Scripts\ViewControllers\Entities\Projectiles\MungBean.cs", "C#", 32, 0, 0, 6, 38
"d:\FileFolder\Life\Unity\Projects\PVZR\PVZ_Rouge\Assets\Scripts\ViewControllers\Entities\Projectiles\Pea.cs", "C#", 54, 0, 0, 8, 62
"d:\FileFolder\Life\Unity\Projects\PVZR\PVZ_Rouge\Assets\Scripts\ViewControllers\Entities\Projectiles\SnipePea.cs", "C#", 32, 0, 0, 6, 38
"d:\FileFolder\Life\Unity\Projects\PVZR\PVZ_Rouge\Assets\Scripts\ViewControllers\Entities\Projectiles\Spike.cs", "C#", 35, 0, 0, 5, 40
"d:\FileFolder\Life\Unity\Projects\PVZR\PVZ_Rouge\Assets\Scripts\ViewControllers\Entities\Projectiles\Star.cs", "C#", 60, 0, 2, 10, 72
"d:\FileFolder\Life\Unity\Projects\PVZR\PVZ_Rouge\Assets\Scripts\ViewControllers\Entities\Zombies\Base\IZombie.cs", "C#", 7, 0, 0, 1, 8
"d:\FileFolder\Life\Unity\Projects\PVZR\PVZ_Rouge\Assets\Scripts\ViewControllers\Entities\Zombies\Base\Zombie.cs", "C#", 437, 0, 31, 105, 573
"d:\FileFolder\Life\Unity\Projects\PVZR\PVZ_Rouge\Assets\Scripts\ViewControllers\Entities\Zombies\Instances\BucketheadZombie.cs", "C#", 28, 0, 0, 6, 34
"d:\FileFolder\Life\Unity\Projects\PVZR\PVZ_Rouge\Assets\Scripts\ViewControllers\Entities\Zombies\Instances\ConeheadZombie.cs", "C#", 28, 0, 0, 6, 34
"d:\FileFolder\Life\Unity\Projects\PVZR\PVZ_Rouge\Assets\Scripts\ViewControllers\Entities\Zombies\Instances\DuckyTubeBucketHeadZombie.cs", "C#", 35, 0, 0, 8, 43
"d:\FileFolder\Life\Unity\Projects\PVZR\PVZ_Rouge\Assets\Scripts\ViewControllers\Entities\Zombies\Instances\DuckyTubeConeheadZombie.cs", "C#", 36, 0, 0, 8, 44
"d:\FileFolder\Life\Unity\Projects\PVZR\PVZ_Rouge\Assets\Scripts\ViewControllers\Entities\Zombies\Instances\DuckyTubeNormalZombie.cs", "C#", 24, 0, 0, 4, 28
"d:\FileFolder\Life\Unity\Projects\PVZR\PVZ_Rouge\Assets\Scripts\ViewControllers\Entities\Zombies\Instances\NewspaperZombie.cs", "C#", 53, 0, 0, 12, 65
"d:\FileFolder\Life\Unity\Projects\PVZR\PVZ_Rouge\Assets\Scripts\ViewControllers\Entities\Zombies\Instances\NormalZombie.cs", "C#", 17, 0, 0, 2, 19
"d:\FileFolder\Life\Unity\Projects\PVZR\PVZ_Rouge\Assets\Scripts\ViewControllers\Entities\Zombies\Instances\ScreenDoorZombie.cs", "C#", 29, 0, 0, 7, 36
"d:\FileFolder\Life\Unity\Projects\PVZR\PVZ_Rouge\Assets\Scripts\ViewControllers\Entities\Zombies\States\AttackingState.cs", "C#", 39, 0, 0, 6, 45
"d:\FileFolder\Life\Unity\Projects\PVZR\PVZ_Rouge\Assets\Scripts\ViewControllers\Entities\Zombies\States\DeadState.cs", "C#", 11, 0, 0, 1, 12
"d:\FileFolder\Life\Unity\Projects\PVZR\PVZ_Rouge\Assets\Scripts\ViewControllers\Entities\Zombies\States\DefaultTargetingState.cs", "C#", 48, 0, 5, 8, 61
"d:\FileFolder\Life\Unity\Projects\PVZR\PVZ_Rouge\Assets\Scripts\ViewControllers\Entities\Zombies\States\OnNewspaperDestroyed.cs", "C#", 16, 0, 0, 2, 18
"d:\FileFolder\Life\Unity\Projects\PVZR\PVZ_Rouge\Assets\Scripts\ViewControllers\Entities\Zombies\States\StunnedState.cs", "C#", 27, 0, 0, 4, 31
"d:\FileFolder\Life\Unity\Projects\PVZR\PVZ_Rouge\Assets\Scripts\ViewControllers\Entities\Zombies\States\ZombieState.cs", "C#", 11, 0, 0, 0, 11
"d:\FileFolder\Life\Unity\Projects\PVZR\PVZ_Rouge\Assets\Scripts\ViewControllers\Entities\Zombies\View\Components\ZombieArmorView.cs", "C#", 33, 0, 0, 2, 35
"d:\FileFolder\Life\Unity\Projects\PVZR\PVZ_Rouge\Assets\Scripts\ViewControllers\Entities\Zombies\View\Components\ZombieComponentView.cs", "C#", 29, 0, 0, 6, 35
"d:\FileFolder\Life\Unity\Projects\PVZR\PVZ_Rouge\Assets\Scripts\ViewControllers\Entities\Zombies\View\ViewController\DefaultZombieViewController.cs", "C#", 65, 0, 5, 7, 77
"d:\FileFolder\Life\Unity\Projects\PVZR\PVZ_Rouge\Assets\Scripts\ViewControllers\Entities\Zombies\View\ViewController\NewspaperZombieViewController.cs", "C#", 75, 0, 6, 9, 90
"d:\FileFolder\Life\Unity\Projects\PVZR\PVZ_Rouge\Assets\Scripts\ViewControllers\Entities\Zombies\View\ViewController\ZombieViewController.cs", "C#", 63, 0, 4, 21, 88
"d:\FileFolder\Life\Unity\Projects\PVZR\PVZ_Rouge\Assets\Scripts\ViewControllers\Entities\Zombies\ZombieAttackAreaController.cs", "C#", 24, 0, 1, 2, 27
"d:\FileFolder\Life\Unity\Projects\PVZR\PVZ_Rouge\Assets\Scripts\ViewControllers\Entities\Zombies\ZombieNode.cs", "C#", 15, 0, 0, 1, 16
"d:\FileFolder\Life\Unity\Projects\PVZR\PVZ_Rouge\Assets\Scripts\ViewControllers\Entities\Zombies\ZombieShieldController.cs", "C#", 29, 0, 0, 5, 34
"d:\FileFolder\Life\Unity\Projects\PVZR\PVZ_Rouge\Assets\Scripts\ViewControllers\Managers\GameManager.cs", "C#", 100, 0, 9, 18, 127
"d:\FileFolder\Life\Unity\Projects\PVZR\PVZ_Rouge\Assets\Scripts\ViewControllers\Managers\GameStarter.cs", "C#", 24, 0, 6, 3, 33
"d:\FileFolder\Life\Unity\Projects\PVZR\PVZ_Rouge\Assets\Scripts\ViewControllers\Managers\SomeInputController.cs", "C#", 148, 0, 8, 18, 174
"d:\FileFolder\Life\Unity\Projects\PVZR\PVZ_Rouge\Assets\Scripts\ViewControllers\Managers\TestDataManager.cs", "C#", 12, 0, 0, 1, 13
"d:\FileFolder\Life\Unity\Projects\PVZR\PVZ_Rouge\Assets\Scripts\ViewControllers\Others\Coin.cs", "C#", 49, 0, 0, 10, 59
"d:\FileFolder\Life\Unity\Projects\PVZR\PVZ_Rouge\Assets\Scripts\ViewControllers\Others\InteractionPromptController.cs", "C#", 26, 0, 0, 5, 31
"d:\FileFolder\Life\Unity\Projects\PVZR\PVZ_Rouge\Assets\Scripts\ViewControllers\Others\LevelEndObjectController.cs", "C#", 62, 0, 3, 13, 78
"d:\FileFolder\Life\Unity\Projects\PVZR\PVZ_Rouge\Assets\Scripts\ViewControllers\Others\LevelScene\FollowingImage.cs", "C#", 71, 0, 3, 12, 86
"d:\FileFolder\Life\Unity\Projects\PVZR\PVZ_Rouge\Assets\Scripts\ViewControllers\Others\LevelScene\LevelTilemapNode.cs", "C#", 24, 0, 0, 7, 31
"d:\FileFolder\Life\Unity\Projects\PVZR\PVZ_Rouge\Assets\Scripts\ViewControllers\Others\LevelScene\ParallaxController.cs", "C#", 50, 0, 2, 10, 62
"d:\FileFolder\Life\Unity\Projects\PVZR\PVZ_Rouge\Assets\Scripts\ViewControllers\Others\LevelScene\SelectFramebox.cs", "C#", 76, 0, 0, 10, 86
"d:\FileFolder\Life\Unity\Projects\PVZR\PVZ_Rouge\Assets\Scripts\ViewControllers\Others\LevelScene\SoyoWaterEffector.cs", "C#", 51, 0, 5, 11, 67
"d:\FileFolder\Life\Unity\Projects\PVZR\PVZ_Rouge\Assets\Scripts\ViewControllers\Others\LevelScene\VirtualCamaraController.cs", "C#", 50, 0, 0, 7, 57
"d:\FileFolder\Life\Unity\Projects\PVZR\PVZ_Rouge\Assets\Scripts\ViewControllers\Others\MazeMap\MazeMapTilemapController.cs", "C#", 14, 0, 0, 3, 17
"d:\FileFolder\Life\Unity\Projects\PVZR\PVZ_Rouge\Assets\Scripts\ViewControllers\Others\MazeMap\TempEndGameObjectController.cs", "C#", 18, 0, 0, 2, 20
"d:\FileFolder\Life\Unity\Projects\PVZR\PVZ_Rouge\Assets\Scripts\ViewControllers\Others\MazeMap\TombstoneController.cs", "C#", 50, 0, 0, 10, 60
"d:\FileFolder\Life\Unity\Projects\PVZR\PVZ_Rouge\Assets\Scripts\ViewControllers\Others\Player.cs", "C#", 106, 0, 3, 26, 135
"d:\FileFolder\Life\Unity\Projects\PVZR\PVZ_Rouge\Assets\Scripts\ViewControllers\Others\Sun.cs", "C#", 44, 0, 0, 9, 53
"d:\FileFolder\Life\Unity\Projects\PVZR\PVZ_Rouge\Assets\Scripts\ViewControllers\UI\ItemView\CardViewController.cs", "C#", 54, 0, 0, 8, 62
"d:\FileFolder\Life\Unity\Projects\PVZR\PVZ_Rouge\Assets\Scripts\ViewControllers\UI\ItemView\CoinViewController.cs", "C#", 13, 0, 0, 2, 15
"d:\FileFolder\Life\Unity\Projects\PVZR\PVZ_Rouge\Assets\Scripts\ViewControllers\UI\ItemView\PlantBookViewController.cs", "C#", 21, 0, 0, 4, 25
"d:\FileFolder\Life\Unity\Projects\PVZR\PVZ_Rouge\Assets\Scripts\ViewControllers\UI\LevelScene\LevelStateBarPanelController.cs", "C#", 60, 0, 2, 8, 70
"d:\FileFolder\Life\Unity\Projects\PVZR\PVZ_Rouge\Assets\Scripts\ViewControllers\UI\LevelScene\SeedController.cs", "C#", 134, 0, 4, 22, 160
"d:\FileFolder\Life\Unity\Projects\PVZR\PVZ_Rouge\Assets\Scripts\ViewControllers\UI\LevelScene\SeedOptionController.cs", "C#", 50, 0, 0, 7, 57
"d:\FileFolder\Life\Unity\Projects\PVZR\PVZ_Rouge\Assets\Scripts\ViewControllers\UI\LevelScene\ShovelController.cs", "C#", 54, 0, 0, 6, 60
"d:\FileFolder\Life\Unity\Projects\PVZR\PVZ_Rouge\Assets\Scripts\ViewControllers\UI\LevelScene\SunpointController.cs", "C#", 24, 0, 0, 8, 32
"d:\FileFolder\Life\Unity\Projects\PVZR\PVZ_Rouge\Assets\Scripts\ViewControllers\UI\MazeMapScene\AwardPanelController.cs", "C#", 76, 0, 5, 15, 96
"d:\FileFolder\Life\Unity\Projects\PVZR\PVZ_Rouge\Assets\Scripts\ViewControllers\UI\MazeMapScene\CardPanelController.cs", "C#", 48, 0, 2, 10, 60
"d:\FileFolder\Life\Unity\Projects\PVZR\PVZ_Rouge\Assets\Scripts\ViewControllers\UI\MazeMapScene\CoinStorePanelController.cs", "C#", 137, 0, 12, 26, 175
"d:\FileFolder\Life\Unity\Projects\PVZR\PVZ_Rouge\Assets\Scripts\ViewControllers\UI\MazeMapScene\CoinTradeNode.cs", "C#", 12, 0, 0, 1, 13
"d:\FileFolder\Life\Unity\Projects\PVZR\PVZ_Rouge\Assets\Scripts\ViewControllers\UI\MazeMapScene\InventoryPanelController.cs", "C#", 38, 0, 0, 8, 46
"d:\FileFolder\Life\Unity\Projects\PVZR\PVZ_Rouge\Assets\Scripts\ViewControllers\UI\MazeMapScene\MazeMapPanelController.cs", "C#", 77, 0, 2, 18, 97
"d:\FileFolder\Life\Unity\Projects\PVZR\PVZ_Rouge\Assets\Scripts\ViewControllers\UI\MazeMapScene\PlantBookPanelController.cs", "C#", 38, 0, 2, 9, 49
"d:\FileFolder\Life\Unity\Projects\PVZR\PVZ_Rouge\Assets\Scripts\ViewControllers\UI\MazeMapScene\RecipeStorePanelController.cs", "C#", 105, 0, 11, 18, 134
"d:\FileFolder\Life\Unity\Projects\PVZR\PVZ_Rouge\Assets\Scripts\ViewControllers\UI\MazeMapScene\RecipeTradeNode.cs", "C#", 12, 0, 0, 1, 13
"d:\FileFolder\Life\Unity\Projects\PVZR\PVZ_Rouge\Assets\Scripts\ViewControllers\UI\MazeMapScene\SellTradePanelController.cs", "C#", 97, 0, 6, 14, 117
"d:\FileFolder\Life\Unity\Projects\PVZR\PVZ_Rouge\Assets\Scripts\ViewControllers\UI\MazeMapScene\StorePanelController.cs", "C#", 29, 0, 0, 5, 34
"d:\FileFolder\Life\Unity\Projects\PVZR\PVZ_Rouge\Assets\Scripts\ViewControllers\UI\Panels\UIChooseSeedPanel.Designer.cs", "C#", 44, 0, 1, 8, 53
"d:\FileFolder\Life\Unity\Projects\PVZR\PVZ_Rouge\Assets\Scripts\ViewControllers\UI\Panels\UIChooseSeedPanel.cs", "C#", 102, 0, 7, 21, 130
"d:\FileFolder\Life\Unity\Projects\PVZR\PVZ_Rouge\Assets\Scripts\ViewControllers\UI\Panels\UIGameStartPanel.Designer.cs", "C#", 44, 0, 1, 8, 53
"d:\FileFolder\Life\Unity\Projects\PVZR\PVZ_Rouge\Assets\Scripts\ViewControllers\UI\Panels\UIGameStartPanel.cs", "C#", 71, 0, 1, 12, 84
"d:\FileFolder\Life\Unity\Projects\PVZR\PVZ_Rouge\Assets\Scripts\ViewControllers\UI\Panels\UILevelGameplayPanel.Designer.cs", "C#", 47, 0, 1, 8, 56
"d:\FileFolder\Life\Unity\Projects\PVZR\PVZ_Rouge\Assets\Scripts\ViewControllers\UI\Panels\UILevelGameplayPanel.cs", "C#", 133, 0, 4, 28, 165
"d:\FileFolder\Life\Unity\Projects\PVZR\PVZ_Rouge\Assets\Scripts\ViewControllers\UI\Panels\UIMazeMapPanel.Designer.cs", "C#", 50, 0, 1, 8, 59
"d:\FileFolder\Life\Unity\Projects\PVZR\PVZ_Rouge\Assets\Scripts\ViewControllers\UI\Panels\UIMazeMapPanel.cs", "C#", 45, 0, 4, 11, 60
"Total", "-", 16057, 181, 1213, 3050, 20501